印度股市投资的分步指南是什么？	投资股票市场的分步指南是什么？	0
科希诺钻石的故事是什么？	如果印度政府偷走了科希诺（Koh-i-Noor）钻石，会发生什么？	0
使用VPN时，如何提高internet连接速度？	通过DNS进行黑客攻击如何提高互联网速度？	0
为什么我精神上很孤独？我怎样才能解决它？	当[math]23^{24}[/math]除以24,23时，求余数？	0
哪一种能很快地溶于水？糖、盐、甲烷和二氧化碳？	哪种鱼能在盐水中生存？	0
占星术：我是摩羯座的太阳，顶着月亮，顶着升起的帽子…这对我来说意味着什么？	我是三重摩羯座（太阳、月亮和摩羯座的上升点），这对我来说意味着什么？	1
我应该买蒂亚戈吗？	是什么让孩子们保持活跃，远离手机和视频游戏？	0
我怎样才能成为一名好的地质学家？	我应该怎样做才能成为一名伟大的地质学家？	1
你什么时候用シ 而不是し?	什么时候用“&”代替“and”？	0
摩托罗拉（公司）：我能破解我的Motorolla DCX3400包机吗？	如何破解摩托罗拉DCX3400免费上网？	0
用菲涅耳双棱镜求狭缝分离的方法？	关于笔记本电脑及其组件的耐用性和可靠性，技术人员能告诉我们一些什么？	0
如何阅读和查找我的YouTube评论？	如何查看我在Youtube上的所有评论？	1
什么能使物理容易学？	你如何使物理容易学？	1
你的第一次性经历是什么样的？	你的第一次性经历是什么？	1
美国有哪些法律可以将你的身份从学生签证改为绿卡，与加拿大的移民法相比如何？	在美国，有哪些法律将你的身份从学生签证改为绿卡？它们与日本的移民法相比如何？	0
特朗普担任总统对目前持有F1签证的国际硕士生意味着什么？	特朗普担任总统将如何影响目前在美国或计划在美国学习的学生？	1
为什么女孩想和她们拒绝的男人做朋友？	男人拒绝女孩后感觉如何？	0
为什么这么多Quora用户发布的问题在谷歌上都能轻易得到回答？	为什么人们会问Quora的问题，这些问题很容易被谷歌回答？	1
班格罗最好的数字营销机构是哪家？	浦那最好的数字营销机构是哪家？	0
为什么火箭看起来是白色的？	为什么火箭和助推器被漆成白色？	1
是什么让人嫉妒？	我该怎么做才能避免嫉妒别人？	0
在Quora上不应该问的问题有哪些？	关于Quora我应该问哪个问题？	0
30千伏的马力是多少？	在哪里可以找到CC到马力的转换图？	0
每次我看钟，数字都是一样的，这是什么意思？	时钟的指针一天重叠多少次？	0
在医药公司面试过程中有哪些技巧？	在基础医学的工作面试过程中有什么秘诀？	0
什么是web应用程序？	什么是web应用程序框架？	0
社会是否过于重视体育运动？	体育如何为社会做出贡献？	0
网上赚钱的最佳方式是什么？	网上要钱的最佳方式是什么？	0
我应该如何准备CA最终法律？	一个人应该如何知道他/她已经为CA期末考试做好了充分的准备？	1
你想做得更好的一件事是什么？	尽管你知道的更多，但你做的一件事是什么？	0
对于一个鼻子在晚上会闷热的人，有什么特别的照顾吗？	我怎样才能不让鼻子在晚上闷热呢？	1
哪个权力游戏的恶棍最有可能宽恕你？	你最想任由哪个权力游戏的恶棍摆布？	1
美国政府是否仍然因为某些美国公民的政治观点而将其列入黑名单（就业等）？	如何确定气体分子的平均速度？	0
西班牙最好的旅游网站是什么？	最好的旅游网站是什么？	0
为什么有些人认为奥巴马会试图拿走他们的枪？	是否有一项枪支管制计划，以取走人们已经拥有的枪支？	0
我今年19岁。我该如何提高自己的技能，或者在未来几年我该如何成为一名企业家？	我是一个19岁的小伙子。我怎样才能在未来10年成为亿万富翁？	0
当一个女朋友问她的男朋友“你为什么选择我？是什么让你想和我在一起？”时，你应该怎么回答她？	我女朋友说我们应该结束这一切，因为她对我的感情感到困惑。我祝她一切顺利。我应该打电话问她是否想重归于好吗？	0
我们如何准备UPSC？	我如何为公务员做好准备？	1
机翼完全后掠的f-14的失速速度和AOA是多少？	为什么飞机停止使用像F-14那样的可变后掠翼？	0
斯拉夫人为什么蹲着？	蹲着会让我的腿变粗吗？	0
我什么时候可以收到确认邮件？	我什么时候能收到确认邮件？	0
我可以通过日间交易每月赚50000美元吗？	我一个月可以做30000天的交易吗？	0
从长远来看，做一个好孩子而不是一个叛逆者值得吗？	无聊对孩子有好处吗？	0
雷克斯诺德从哪些大学招收新毕业生？他们在找什么专业？	B&G食品从哪些大学招收新毕业生？他们在找什么专业？	0
增加Instagram粉丝的最快方法是什么？	我们如何增加Instagram的粉丝数量？	0
达斯·维德在《星球大战》传说中是如何与达斯·摩尔作战的？	Quora对配置文件描述有字符限制吗？	0
夫妻分手的阶段是什么？我的意思是，在感情上分手后，不管是男是女，会发生什么？	分手对谁的影响更大，男孩还是女孩？	0
原油可以生产的产品有哪些？	哪些产品是由原油制成的？	1
我如何交朋友。	如何交朋友？	1
职业发射器适合RBI B级准备吗？	RBI B级的职业启动在线计划如何？	1
蓝光会在普通DVD播放机上播放吗？如果是，怎么做？	如何在普通DVD播放机上播放蓝光DVD？	1
她总是悲伤吗？	空气动力学螺旋桨旋转时会发生什么？	0
你吃过的最好/最难忘的东西是什么？为什么？	你吃过的最美味的菜是什么？为什么？	1
GST如何影响CAs和税务官员？	为什么我不能做作业？	0
进入RSI有多困难？	当你是一名升高中生时，你会申请像RSI这样的项目吗？	0
谁是我的朋友？	我的男朋友是不是在谎报他对朋友的真实感情，他是否暗中被她吸引？	0
有什么好的说唱歌曲可以伴舞？	哪些是最好的说唱歌曲？	0
我突然被Gmail注销了。我记不起我的Gmail密码了，才意识到恢复邮件已经不存在了。我能做什么？	我记不起我的Gmail密码或我的恢复电子邮件。如何恢复我的电子邮件？	1
学习法语最好的方法是什么？	我如何学习法语性别？	0
我如何在没有注册的情况下从kickass torrent下载内容？	Kickass Torrents值得信赖吗？	0
在我的虹膜周围有一个黑圈是正常的吗？	是什么导致虹膜周围出现暗环？应该如何治疗？	0
哈利波特的新书《哈利波特与被诅咒的孩子》怎么样？	J.K.罗琳的新书有多糟糕？	1
为什么我总是感到沮丧？	为什么我晚上总是情绪低落？	0
在哪里可以找到欧洲家族理财办公室数据库？	在哪里可以找到美国家族理财办公室数据库？	0
什么是Java编程？如何学习Java编程语言？	我如何学习像java这样的计算机语言？	1
有史以来最好的书是什么？	你读过的最重要的书是什么？	1
我们能储存闪电产生的能量吗？	有可能储存闪电的能量吗？	1
你对性能测试的评价是什么？	什么是性能测试？	0
像德国那样的隐私是以什么为代价的？为了获得如此多的隐私，还损失了什么？	有没有人真正喜欢不加调味品的沙拉？	0
什么类型的免疫？	我们身体中有哪些不同类型的免疫力？	0
我怎样才能说一口流利的英语？	我怎样才能学会流利地说英语？	1
QuickBooks的自动数据恢复支持电话号码对恢复损坏的数据文件有多大帮助？	quickbooks美国客户支持电话号码是多少？	1
谁是有史以来最富有的赌徒，我怎样才能达到他的水平？	谁是有史以来最富有的赌徒？我怎样才能达到他作为赌徒的水平？	1
如果我从比子弹快的飞机上向后发射子弹；子弹会倒吗？	子弹从枪里射出时的传播速度比音速快吗？如果没有，可能吗？如果他们这样做了，用什么枪，会造成多大的破坏？	0
如何预防乳腺癌？	乳腺癌是可以预防的吗？	0
如何在朋友的手机上注销我的Gmail帐户？	我怎么知道谁登录了我的Gmail帐户？（通过告诉他的IP地址或设备名称）？	0
我如何通过互联网赚钱？	除了卖东西，网上赚钱有哪些不同的方式？	0
人生的目的是什么？	生活的目的是什么？生活到底是关于什么的？	1
印度人民党政府什么时候会剥夺所有穆斯林和基督教徒的印度公民身份，并将他们安置在像缅甸罗兴亚人那样的船只上？	印度为什么不采用“缅甸罗兴亚模式”驱逐非法孟加拉国人？	0
祝耶和华见证人生日快乐的正确礼仪是什么？	第一个祝某人生日快乐有多重要？	0
如果有人想在印度的任何一个城市开设一家商业调频广播电台，费用是多少，程序是什么？	我想为印度和新西兰制作一个旅游广告/高清视频剪辑。要多少钱？	0
为什么瑞士人鄙视亚洲人？	为什么技术员工如此轻视销售人员？	0
生物技术领域的高薪工作有哪些？	生物技术硕士的新生有哪些高薪工作？	1
21岁以后我该如何增加身高？	25岁以后身高会增加吗？	1
柬埔寨地震的主要影响是什么？这些影响与1952年的堪察加地震相比如何？	柬埔寨地震的主要影响是什么？这些影响与1822年瓦尔帕莱索地震相比如何？	1
真诚和公平有什么区别？	诚实和真诚有什么区别？	0
在60千卢比以下，哪一款是最好的游戏笔记本电脑？	60000卢比以下最好的游戏笔记本电脑是什么？	1
你对《下一个勇士：试验场》第9部分有何评论？	你对《下一个勇士：试验场》第5部分的评论是什么？	0
物理11班最好的参考书是什么？	我应该选择哪本书作为物理和化学的参考书（CBSE委员会11班）？	0
国家理工学院，库鲁克什特拉：苏拉什卡尔尼特的社会生活怎么样？	卡纳塔克邦国立理工学院（NITK），Surathkal：对于即将毕业的学生：在你离开之前，你想给你的三年级学生上什么课？	0
英语中最浪漫的电影有哪些？	你看过的最浪漫的电影是什么？	1
什么导致噩梦？	是什么导致了看起来真实的噩梦？	1
绘画中的抽象表现主义是什么？	抽象表现主义的一些主要影响是什么？	0
和Jeremy Ehrhardt一起上加州理工学院是什么感觉？	谁是加州理工学院的知名人士？	0
为什么哈利变成了魂器？	什么是魂器？	0
20岁出头的人可以参加什么样的最佳产品经理助理（APM）课程来学习产品管理，并在公司获得有意义的职业生涯？	在基于产品的软件公司中，成为产品经理或项目经理的一般要求是什么？	0
为什么Skype的电话号码1-855-425-3768总是占线？	如何让Skype在android 4.1.1手机上工作？	0
印度和巴基斯坦之间真的会因为Uri攻击而发生战争吗？它会有什么影响？	印度和巴基斯坦之间会发生核战争吗？	1
罗纳德·里根（Ronald Reagan）的演讲中有没有矫揉造作？	罗纳德·里根对9·11有何反应？	0
南北战争期间，联邦和邦联的战争策略是什么？	在美国内战期间，南部邦联怎么可能在葛底斯堡击败联邦军队？	0
2016年最好的小说是哪部？	哪些是最好的小说？	0
如果我忘记了密码，我可以恢复我的电子邮件吗？	如果我忘记了电子邮件密码，我该怎么办？	1
最近的货币停止流通是否会导致更高的GDP？如果是，多少钱？	从短期和长期来看，废止货币化将如何影响印度的GDP？	0
你听说过旅行黑客吗？	WhatsApp能被黑客攻击吗？	0
共和国银行的招聘流程有多具有竞争力？	科技银行的招聘流程有多具有竞争力？	0
谷歌如何帮助调整搜索结果的垃圾邮件排名？	谷歌有机搜索结果之间的流量分布是什么？e、 排名第1对第2，第一页对第二页	0
哪里可以看有英文字幕的gonulcelen？	哪里可以看带字幕的sarrainodu？	0
美国是世界上最强大的国家吗？	为什么美国是世界上最强大的国家？	0
如何获得即时溃疡疼痛缓解？	什么对腰痛更好：热的还是冰的？	0
利用某人意味着什么？	占某人的便宜或追求物质利益更糟糕吗？	0
为什么我们在快乐和悲伤的时候哭泣？	我们为什么哭泣？	0
为什么有些女孩拍照时喜欢伸出舌头？	为什么青少年女孩（和一般女性）允许他们的男朋友在这个时代和（数字）时代给他们拍裸照？	0
你觉得小说《1984》的结尾令人沮丧吗？	温斯顿和朱莉娅在小说《1984》中有什么不同？它们有什么相似之处？	0
有哪些令人兴奋的电脑工具是大多数人不知道的？	有哪些令人兴奋的技术是大多数人不知道的？	0
在使用牙膏之前，牙刷应该是湿的还是干的？	最便宜的牙膏是什么？	0
为什么我的问题被标记为需要改进？	我怎么能问一个问题而不被标记为“需要改进”？	1
中性状态和缓冲状态之间的区别是什么？	如果美国每个州都互相宣战，哪个州会赢？	0
什么矿物具有最高的电荷？	什么矿物能保持最大的电荷？	1
宇宙中最大的奥秘是什么？	有史以来最大的谜团是什么？	0
机器学习的替代方案是什么？	如何对多类不平衡数据集进行过采样？	0
为什么中国在联合国阻止对正义运动（JeM）主席马苏德·阿扎尔（Masood Azhar）的制裁？	中国为什么支持马苏德·阿扎尔？	1
未来的预算意味着什么？	未来的意义是什么？	0
过量的维生素C会导致我流产吗？	维生素C如何导致流产？	1
在朝日印度玻璃公司工作是什么感觉？一年或两年后的薪级是多少？	在我们收到朝日印度玻璃招聘意向书后，我们什么时候会收到电话通知？	0
如何进入印度的Torbox？	如何从印度访问Google.com？	0
什么是yakshini咒语？	什么是扬特拉咒语？	0
六方会谈成功了吗？	NICMAR哪门课程更好？	0
如何注册我的域站点电子邮件？	如何注册域名？	0
老年男性被年轻女性吸引是正常的吗？	为什么老男人会吸引我？	0
受压时，最坚固的结构或最坚固的形状是什么？	什么是最强的凯夫拉绳？	0
罗兴亚穆斯林是谁？	罗兴亚人是谁？	1
人类是自私还是邪恶重要吗？	人类是否邪恶重要吗？	1
胞吐和胞吞是主动运输还是被动运输？	细胞内被动运输的例子有哪些？	0
我是怎么秃头的？	如果我在秃头的时候剃了两年的头，然后长出了头发，头发会和我最初剃的时候一样吗？还是我松了更多的头发？	0
退休后的理想生活是什么？	退休后的生活是什么？	0
我们对巴基斯坦的立场是什么？	巴基斯坦对朝鲜拥有大规模杀伤性武器持什么立场？是支持朝鲜还是反对朝鲜？	0
什么是好的护送网站？	我怎样才能找到一个好的护卫？	0
哪一个更好的是polo柴油机还是grand i10汽油机？	对于成长中的十项全能运动员来说，什么是最好的饮食？	0
黑洞有质量吗？	黑洞的质量有限吗？	1
摩根·弗里曼（Morgan Freeman）说停止种族主义的唯一方法就是停止谈论它，这对吗？	你对摩根·弗里曼关于种族主义的这句话有什么看法？	1
Fab目前是否向新员工提供股票期权或RSU？	优步目前是否向新员工提供股票期权或RSU？	0
你将如何审查该网站？	有一个好的付费评论网站吗？	0
我们可以通过多少种方式将10支外观相同的铅笔分发给4名学生，以便每个学生至少获得一支铅笔？	有多少种方法可以将12个苹果分发给4个孩子，使每个孩子至少得到2个苹果？	0
雇佣杰瑞·宋飞一到两个小时要花多少钱？	录制一个2小时的演示文稿平均要花多少钱？	0
在可能的非咬伤接触后，接种狂犬病疫苗是否已经晚了7天？	狗咬伤1天后我可以注射狂犬病疫苗吗？	0
英国统治印度多少年？	国际搬迁的标准休假时间是多少？	0
我怎样才能不再害怕工作？	你怎样才能停止害怕一切？	0
为什么瑞德把钥匙放在OITNB里？	为什么红色在《橙色是新的黑色》第四季保留钥匙？	1
一个人应该在什么年龄失去童贞？	你在什么年龄、如何以及在哪里失去童贞？	0
你有多健忘？	我怎么能忘记我的妻子？	0
斯努克会秘密地成为达斯·摩尔吗？	如果斯努克被帕尔帕廷皇帝杀死，他怎么可能是达斯·普雷格斯呢？	0
如果我不将YouTube视频盈利并上传版权内容，那么谷歌是否有可能封锁我的账户？	你如何在YouTube上上传电影并将其盈利？有版权问题吗	1
你能从佳能6D换成徕卡D-LUX 109吗？	我应该为我的佳能6D买什么样的三脚架？	0
Quora网站对Quora moderation的成员来说是什么样子的？	Quora对主持人有何看法？	1
为什么没有人用Quora回答我的问题？	为什么在库拉没有人回答我的问题？	1
你知道的最有趣的笑话是什么？	有史以来最有趣的笑话是什么？	1
我在伦敦Chelmsford Essex得到了一份工作，扣除税后工资为3764英镑。请告知夫妇每月的暂定费用有可能节省吗？	如果我要离开挪威，我可以用我的BSU账户支付我的抵押贷款，然后卖掉我的公寓而不必偿还我因拥有BSU而获得的税收减免吗？	0
对英国的成见是什么？	美国人对英国有什么看法？	0
我如何使用Twitter作为业务来源？	我如何使用Twitter开展业务？	1
如何将资金从Skrill转到PayPal帐户？	我如何从我的PayPal帐户将钱汇入我的Skrill帐户进行取款？	0
哪一款耳机的低音低于1000？	1000卢比以下的耳机哪种最好？	1
政府雇员有资格获得Sukanya Samrudi Yojana吗？	政府雇员可否申请独立选举委员会？	0
“期待与您交谈”或“期待与您交谈”哪个是正确的？	哪一个是正确的：“与”或“与”说话？	0
哪些是最好的工程领域？	什么是最好的工程领域？	1
你如何让生活适合你，阻止生活在精神上和情感上虐待你？	为什么我的生活中会有情绪虐待的人？一些前男友、朋友和过去的同事/老板都是虐待者。我吸引他们吗？	0
工资总额和CTC之间有什么区别？	我的周薪和雇主同意的年薪之间似乎有差异，这是怎么回事？	0
喀拉拉邦哪些是繁荣的城镇？	喀拉拉邦为什么有这么多基督徒？	0
获得自信的最佳方式是什么？	我怎样才能说得更清楚、更自信？	0
有人看到希腊神和印度神之间的关系吗？	印度神话、希腊神话、埃及神话等诸神之间有什么相似之处。？	1
如何从Apple Music切换到Spotify？	我应该从Spotify切换到Apple Music吗？	0
哪一个是最好的固定收益基金？	什么是最好的固定收益基金？	1
住在科隆是什么感觉？	住在德国克伦是什么感觉？	1
在罗伯特·德尼罗和阿尔·帕西诺之间，谁更成功？	你认为谁是最佳男演员，罗伯特·德尼罗还是阿尔·帕西诺？	0
为什么有些人喜欢小家庭。？	为什么有些人喜欢和小家庭住在一起？	1
动物接吻吗？	动物（除了人类）接吻吗？	1
如何删除Instagram聊天记录？	如何查看已删除的Instagram dms？	1
我怎样才能停止对爱的沉迷？	我如何停止对某人上瘾？	0
如果我雇了两个私人侦探，命令他们互相跟踪怎么办？	我能雇佣两名私人调查员，然后让他们互相跟踪吗？	1
如何找到创业加速器？	创业加速器如何为您提供资金？	0
如何查看wifi历史记录并通过android手机访问？	我无法通过WiFi路由器打开Quora。为什么我只能通过移动网络访问它？	0
索姆之战的意义是什么？这场战役与罗斯托夫之战相比有何意义？	索姆之战的意义是什么？这场战斗与利雅得之战相比有何意义？	1
你读过的最有创意的大学入学论文是什么？	有没有大学招生官在读申请者的论文时当众大哭？	0
如果你用眼罩遮住一只眼睛一年，然后取下眼罩，会发生什么？	如果眼部药物进入眼睛会发生什么？	0
在生活中有可能追求很多不同的东西吗？	我如何拒绝在生活中的不同事情之间做出选择？	1
作为蝙蝠侠，本·阿弗莱克比克里斯蒂安·贝尔更耀眼吗？	请不要影迷，但谁是真正的蝙蝠侠，克里斯蒂安·贝尔还是本·阿弗莱克？	1
在海得拉巴，哪一家企业是良好的初创企业？	在海得拉巴开办哪家企业更好？	1
我怎么才能停止占有欲？	我怎样才能停止对我爱的人过分占有？	1
克里希纳勋爵的妻子是谁？	谁是主奎师那的父亲？	0
为了提升我的职业生涯，我可以与CA一起学习的最佳课程组合是什么？	什么课程必须与CA课程一起学习？	1
如何在Mac笔记本电脑上截图？	如何在MacBook Pro上截图？有什么说明？	1
高管招聘人员的工作是什么样的？	与高管招聘人员一起工作是什么感觉？	0
“收集”满足了哪些心理需求？	人们为什么收集东西？	0
你死前必须看哪些电视节目？	有必须看的电视节目吗？	1
我怎样才能更流利地说中文？	我怎样才能说一口流利的中文？	1
500卢比和1000卢比纸币的非货币化对房地产行业有何影响？	报废汽车会产生什么影响₹500和₹房地产市场上的1000卢比纸币？	1
成为亿万富翁（美元）最简单的方法是什么？	成为亿万富翁的最佳方式是什么？	1
有没有人愿意在印度的大学里做免费讲座或举办免费研讨会？	服用百忧解将近两周了，为什么我仍然觉得反社会，仍然不想去参加活动？为什么我的社交行为和情绪每天都在变化？	0
开始学习机器人技术的最佳方式是什么？	启动机器人技术的最佳方式是什么？哪一个是我能开始工作的最好的开发板？	0
为什么人们讨厌希拉里·克林顿？	人们不喜欢希拉里·克林顿的原因是什么？	1
为什么经期妇女被认为是“不洁的”，以至于她们不能积极参加宗教仪式（印度教）？	为什么人们总是期望一个女人应该照顾家务、孩子和烹饪（特别是在印度文化中）？这些活动仅仅是妇女的责任吗？为什么男人不平等地分担这种工作？	0
如果无神论是缺乏对神的信仰，那么没有神的信仰的术语是什么？	无神论是缺乏对神的信仰，还是声称神不存在？	0
《刺客信条》系列的最佳引用/教训是什么？	在刺客信条中，哪位刺客的长袍最好？	0
喷墨打印机在打印黑白文档时是否使用彩色墨水？若然，原因为何？	如果CMYK打印机使用彩色墨水打印黑色，并且只使用黑色墨水进行补充，为什么商店对彩色打印收取更多费用？	0
如果希拉里·克林顿不能继续她的总统竞选活动，民主党将如何选择新的候选人？	如果希拉里·克林顿不能再担任民主党提名人，她的继任者将如何选择？	1
耳机如何作为天线在手机上播放调频广播频道？为什么移动公司不在手机上安装相同的内置天线，以便在没有耳机的情况下播放调频？	为什么手机没有内置调频天线？	0
除了自动化工具之外，自动化工程师的最佳职业发展技术是什么？	喜马拉雅山还是杜克KTM 200巡演？	0
在NSE上市公司的缺点是什么？	在NSE上市公司有什么好处？	0
一个物体相对于时间的位置有多少导数是连续的？	绘画什么时候变得有趣？	0
中子星是由什么组成的？	中子星是由中子组成的吗？	1
我的平均成绩是3.8分。进入哈佛这样的顶尖大学就足够了吗？	平均绩点3.8分足以进入顶尖学校吗？	1
交易二元期权的盈利方式是什么？	什么是二元期权交易？	0
我如何利用空闲时间来避免抑郁？	像LIK这样从IIM毕业的人，甚至像Ranchi和Trichy这样的新IIM毕业的人，能赶上ABC的毕业生，得到类似的待遇吗？	0
如何学习计算机安全？	如何开始学习信息安全？	1
我如何从Quora那里挣钱？	我能在Quora上赚钱吗？	1
我的puk代码是什么？	TF64SIMC4的PUK是什么？	1
我怎样才能在日本找到工作？	我怎样才能在日本找到IT工作？	0
使用“歇斯底里”这个词的句子有哪些例子？	最佳家庭无线网络设置和预期速度是什么？	0
还会有另一个10亿美元的彩票头奖吗？	彩票什么时候能达到下一个10亿美元的头奖？	1
考虑到所有的转弯，在去哈纳的路上开车有多可怕？	我需要一辆四轮驱动汽车在去哈纳的路上一路行驶吗？	0
如何使用C编程（Linux终端）在新终端中创建新的shell？	如何使用C编程在Linux中创建新的终端和新的shell？	1
认知影响知觉吗？	认知紧张会影响消化吗？	0
TQWL与CKWL（塔特卡尔等待名单）有何不同？	我订了一张火车票，但在塔卡尔的候车名单上。如果我取消它，我会得到退款吗？	0
我们如何才能使世界成为子孙后代居住的更美好的地方？	我能做些什么让世界变得更美好？	1
传奇联盟有多少冠军？	谁是最好的LoL（传奇联盟）冠军？	0
每天喝4升水不健康吗？	如果我每天跑5公里，我应该喝多少升水？	0
五大湖的水从哪里来，这些湖泊的野生动物与普雷斯帕湖相比如何？	五大湖的水从哪里来，这些湖泊的野生动物与科莫湖相比如何？	0
色情明星看色情片吗？	我怎样才能预订Ronda Rousey出演成人电影？	0
特朗普的支持者们，你对他兑现承诺的方式有何感受？	特朗普的支持者现在是否期望总统兑现他如此有力地兑现的承诺？	0
我们为什么担心别人的意见？	为什么我们关心别人的意见和别人对我们的看法？	1
你如何训练一只4个月的斗牛犬？	我如何训练我两月大的拉布拉多小狗？	1
如果我跳绳五分钟，我会消耗多少卡路里？	跳绳最好的方法是什么？	0
在CS stream中，哪个在线测试系列最适合GATE 2017？	哪种测试系列最适合GATE计算机科学流？	1
新手理解算法分析的最佳材料是什么？	一个完全的新手需要什么数学来理解计算机编程的算法？哪些关于算法的书籍适合初学者？	0
斗牛獒/哈士奇混血犬的气质是什么？	柯基哈士基混血儿的气质是什么？	0
有8个球。其中7个重量相同。其中一个有不同的重量（你不知道它是重还是轻）。你如何找到这个2磅重的球？	使用0、1、2、3、4、5、6和7可以形成多少个4位数？其中有多少在4000到6000之间？	0
在戏剧《阳光下的葡萄干》中，沃尔特·阿德·贝尼亚塔为什么要争论？	在《阳光下的葡萄干》中，沃尔特和贝尼亚莎为什么要争论？	1
一个超级聪明的人装傻的标志是什么？	超级聪明的人隐藏他们的智慧的迹象是什么？	1
如果暗能量是通过膨胀而产生的，那么无限的暗能量能被创造吗？	如果能量在膨胀的宇宙中不守恒，那么势能是无限的吗（可以创造的能量是无限的）？	1
你是怎样出版一本书的？	写和出版一本书的好方法是什么？	0
谁在破坏彭博社？	谁将颠覆彭博社？	1
为什么flash跑得这么快？	闪光灯（DC角色）：闪光灯能以多快的速度跑一英里？	0
合法投资500美元的最佳方式是什么，这样我就能在相对较短的时间内（比如6个月）获得有形利润？	我怎样才能最好地投资₹在接下来的6个月里有5000人？	0
GST法案的实施将如何影响普通人的生活？	商品及服务税法案到底是什么？它将如何影响普通民众？	1
你如何恢复你的Gmail密码？	我记不起我的Gmail帐户密码，如何恢复我的帐户？	1
精神疾病的诊断准确度如何？	我怎样才能准确地诊断和治疗我的精神疾病？	1
20岁女孩的膝盖疼痛正常吗？	14岁的女孩吐血正常吗？	0
一个好领导的品质是什么？	领导者有哪些优秀品质？	1
海湾、海湾和海峡有什么区别？	大海和海湾到底有什么区别？	0
莫迪会在2019年获胜吗？	纳伦德拉·莫迪能否在2019年成为印度总理？	1
我如何在印度开设DMart商店？有特许经营权吗？	如何获得reliance数字商店特许经营权？	0
学习医学最好的YouTube频道是什么？	学习Git最好的YouTube频道有哪些？	0
斯瓦米·维韦卡南达在环游世界的旅途中吃过非蔬菜或鸡蛋吗？	为什么大多数印度教徒不吃非素食？	0
如果我在图表绘制完成之前取消TQWL票据，会发生什么？	我们能取消一张“塔卡尔等候名单”的票吗？	0
“共同核心倡议/标准”到底是什么？利弊如何？	共同核心标准倡议的优缺点是什么？	1
我如何选择一份期刊来发表我的论文？	我在哪里发表论文？	1
你2017年的新年计划是什么？	你2017年的创意新年计划是什么？	1
如果你做了一个恶梦，你会怎么做？	你怎么能不做恶梦呢？	0
斯拉夫人为什么蹲着？	蹲着对男人有用吗？	0
我应该为AIIMS排名151得多少分？	要进入AIIMS前50名，我的最低分数应该是多少？	0
在手术室里，当两位经验相同的外科医生在手术过程中意见不一致时，如何打破僵局？	医生：外科医生如何坚持手术时间超过6小时？手术期间他们休息吗？	0
从零开始开发Android应用程序需要多少个月的时间？	从零开始学习Android应用程序开发需要多少时间？	1
作为一个男人，我如何爱我的身体？	如果我是一个温顺的印度人，我怎样才能使我的整个身体更公平呢？	0
囚犯的权利是什么？	如果我在监狱里，我有什么权利？	1
我如何在部族冲突中获得免费宝石？	我怎样才能得到免费的宝石部族冲突？	1
为什么没有更多像Word Lens这样的应用程序？	Word Lens用于OCR的是什么？	0
我的前女友得了疟疾。我很想去看望她，但我有自己的安排。我不知道如何和她在一起。我该怎么办？	我是否应该担心我的女朋友会在凌晨4点前给她的前男友发短信，如果是，为什么？	0
获得网站流量的最佳方式是什么？	如何获得网站的流量？	1
当有人在Quora上投票支持你的答案时，你感觉如何？	在Quora上看到你的答案的投票是什么感觉？	1
有哪些最优秀的电影和电视剧以强势女性主角为主角？	电影中最好的女性角色是什么？	1
你会为爱走多远？我应该等我爱的人离开吗？	作为一个十三岁的孩子，我能为我的健康做的最好的事情是什么？	0
大多数人是怎么死的？	人是怎么死的？	0
为什么现在大多数衣服是用聚酯纤维而不是棉做的？	棉布衣服是怎么做的？	0
骨髓里有什么？	骨髓是什么味道？	0
有没有叫Reddice的奴隶？	在古罗马，奴隶被打上烙印。如果品牌标志后来被解放了，会发生什么？	0
溺水后尸体浮到水面需要多长时间？	当一具尸体在河里时，它需要多长时间才能浮起来？	1
我怎么才能忘记一个已经三年没说话但仍然想念他的朋友呢？	既然我们去年分手了，而我仍然想念她，我怎么才能忘记我爱的人呢？	0
当你去一个新的地区旅行时，你最好是沉浸在1-2个城市中，还是尽可能多地去看看你能挤进的城市？	在不花钱的情况下探索世界的方法是什么？	0
我如何在网上免费赚钱？	我如何在网上赚钱？	1
在黄金海岸哪里可以买到质量最好的定制纸杯蛋糕？	在黄金海岸哪里可以找到美味的纸杯蛋糕？	1
奇偶计划有多成功？	德里的奇偶计划有多成功？	1
如果印度和巴基斯坦之间发生战争，谁将获胜？	如果印度和巴基斯坦之间爆发战争，谁将获胜？	1
你如何处理对死亡的恐惧？	你如何减少对死亡的恐惧？	1
修复iPhone6破裂的屏幕的估计成本是多少？	修理一个坏掉的iPhone6屏幕我要付多少钱？怎样才能做到呢？	0
2016年麦当劳推出的最有趣的产品和创新是什么？	2016年Ball推出的最有趣的产品和创新是什么？	0
宇宙有尽头吗？如果没有，宇宙是无限的吗？	宇宙是无限的还是宇宙的尽头？	1
什么是CPAGrip.com？	什么是bestmytest.com？	0
安娜·哈扎尔对莫迪总理有何看法？	你们认为阿文德·凯伊里瓦尔先生和他的AAP怎么样？	0
禁止在印度股市发行500和1000张纸币会产生什么影响？	1000卢比和500卢比纸币的禁令将对股市产生什么影响？	1
同心收缩和偏心收缩有何不同？	同心收缩和偏心收缩如何比较和对比？	1
为什么他们在《第一集》中为尤达使用的木偶那么差劲？	为什么人们不质疑社交媒体网站上发布的“新闻”帖子和观点？	0
我可以在哪些在线平台上发布啤酒赚钱机会的广告？	我可以在哪些在线平台发布啤酒赚钱机会的广告？	0
这一生的意义是什么？	生命的意义是什么？	1
我应该如何有效地创办小企业？	我应该如何在建筑业创办一家小企业？	0
我们怎样才能获得积极的道德？	什么是定期存款？RD和FD是定期存款的类型吗？	0
你需要朋友吗？	为什么我们需要朋友？	0
我存在吗？	我们存在吗？	0
好莱坞最好的惊悚片是哪部？	好莱坞最好的惊悚片是什么？	1
我应该重读大学二年级，还是找一所新的大学？这是一门5年的课程。	我在加尔各答的阿舒托什学院学习。我能在第二年在印度的其他大学学习吗？	0
如何在加油站使用发动机将汽油或柴油泵送上来而不引起任何火灾？	当你给汽油车加柴油时会发生什么？如果发生此类事件，解决方案是什么？	0
国土安全部的单身汉有什么工作机会？	拥有国土安全学士学位的人可以从事哪些工作？	1
理解微积分最好的书是什么？	什么是自学微积分的好书？	1
你为什么和她/他分手，又是怎么分手的？	你是怎么和你的前任分手的，为什么？	1
我可以在iPhone 5s中使用Jio SIM卡吗？	iphone5s支持JIO-VoLTE吗？	0
美国有哪些不成文的规定？	你家里有哪些不成文的规定？	0
对于你在两年的工作面试中所做的事情，最好的答案是什么？	什么是最好的借口来解释你的工作生涯中的一年或两年的空缺？	1
适合低声的最佳歌曲是什么？	有哪些歌曲适合甜美、轻快的中音？	0
有人能预测我的出生图吗？	关于这个出生图，你能告诉我什么？	0
三角函数是什么时候诞生的？	谁是三角学的创造者？	0
这句话是什么意思；“不要相信你看到的一切，即使盐看起来像糖”？	人们说“不要试图取悦他人”。对他人友善是否意味着取悦他人？	0
各国如何防止战争？	各国应该如何防止战争？	1
我怎样才能成为亿万富翁？	我怎样才能成为亿万富翁（金融界）？	1
我为什么要学习网页设计？	如何学习网页设计？	0
最好的在线日历/日程安排/预订系统是什么？让我展示我的可用性的东西&客户可以“请求”与我会面。当我“接受”他们的请求时，约会会弹出到我们的日历中，并自动提醒。	是否有一个web服务可以向从谷歌日历提取数据的客户发送约会短信提醒？	0
禁止发行500和1000卢比纸币会对印度GDP产生怎样的影响？	禁止500卢比和1000卢比纸币对印度经济有什么影响？	1
为什么理解死亡是哲学的？	是什么让理解死亡成为哲学？	1
为什么狗被认为是杂食动物？	狗是食肉动物吗？	1
在一段关系中被欺骗是什么感觉？	和一个被你欺骗的人在一起是什么感觉？	0
我如何知道是否有人阻止了我的短信？	如果我关闭了我的用户id，我可以给阻止我的人发短信吗？	0
在任何国家，你吃过的最有趣的食物是什么？	你吃过的最美味的菜是什么？为什么？	1
做一名私人银行家是什么感觉？	在瑞士当私人银行家是什么感觉？	0
新闻对你来说是什么？	什么是新闻？	0
如何提高注意力？	如何提高我的注意力？	1
如果我没有更多待处理的邀请，我如何看待Linkedin上的“已发送邀请”？	如何个性化LinkedIn邀请？我想我刚刚在LinkedIn上向一位同事发送了一份邀请，但没有机会对其进行个性化设置！	0
德国牧羊犬的优点和缺点是什么？	养宠物德国牧羊犬的利弊是什么？	1
自然神论和不可知论有什么区别？	爱好和习惯有什么区别？	0
为什么男性色情明星会手淫射精？	丈夫和妻子一起手淫可以吗？如果你的伴侣未经你同意而手淫，这算是欺骗吗？	0
我需要多少CGPA才能在IIT Madras获得MTech CSE入学资格？	从IIT获得CSE的Mtech后，我能在咨询公司找到工作吗？	0
人们情绪激动时会哭，这有生物学上的原因吗？	哭的生理原因是什么？	0
关于地壳的五个事实是什么？	地核是如何影响地壳的？	0
ISRO为什么不使用搅拌摩擦焊接技术？	如果一个男人担心和一个他曾经是朋友的女孩约会的诱惑，他应该重新评估他现在的关系和感觉吗？	0
我希望为在我的iOS设备上运行的应用程序模拟一个假位置。你如何在不越狱的情况下为iOS伪造GPS定位？	我怎样才能在不越狱的情况下伪造我的iPhone位置？	0
戒烟的最好方法是什么？	你是怎么戒烟的？	1
哪种语言是tcs最好的编程语言？	哪种编程语言最好？	0
抗震房屋？	抗震建筑是如何工作的？	1
克里斯汀·斯图尔特是个坏演员吗？为什么？	詹妮弗·劳伦斯是个坏演员吗？	0
为什么一些日本男人要看起来像女人？女孩们不觉得很恶心吗？	为什么印度的大多数人变得如此绝望？难道他们不知道女孩们并不总是寻求关系吗？先成为我们的朋友会伤害到男人吗？	0
五个最受欢迎的糖爹网站是什么？	和美洲豹或糖爹约会是什么感觉？	0
2016年VTU第一次sem考试时间表是什么（12月）？	我如何制定4个月的时间表，以破解2016大门？	0
15k以下的手机最好买什么？	15000以下的手机最好买哪款？	1
我们如何创业？	我如何从无到有开始做生意？	1
你有过的最好的濒死体验是什么？	有人有过濒死经历吗？	1
为什么我总是从我的狗身上得到跳蚤？	我怎样才能防止我的狗长跳蚤？	1
字母J是哪一年来的？	字母J是什么时候产生的？	1
哈佛大学课程：土耳其课程的一般购物建议是什么？	哈佛大学课程：泰米尔语课程的一般购物建议是什么？	0
如何通过蓝牙将信息从一部Android手机发送到另一部Android手机？	如何将联系人从一部Android手机转移到另一部Android手机？	0
有史以来最重要的书是什么？	你读过的最重要的书是什么？	1
西格玛设计从哪些大学招收新毕业生？他们在找什么专业？	西格玛·奥尔德里奇从哪些大学招收新毕业生？他们在找什么专业？	0
在英国攻读硕士学位（心理学硕士）后，我们能在印度攻读硕士学位吗？	我是一名硕士生，对人道主义领域的工作感兴趣。需要什么技能？我是一名在英国攻读硕士学位的医生	0
鲍威尔工业公司从哪些大学招收新毕业生？他们在找什么专业？	查特工业公司从哪些大学招收新毕业生？他们在找什么专业？	0
你见过的最好的电影海报是什么？	最好的标志性电影海报是什么？	0
氘霉科的一些例子是什么？它们是如何形成的？	所有的比特币开采都能由一个树莓皮完成吗？	0
种族主义怎么会太种族主义？	你有多种族主义？	0
然而，两者之间有什么区别吗？	两者之间有什么区别？	0
加拿大鹅真的是加拿大人吗？	加拿大人怎么称呼加拿大？	0
如何找到多项式函数[math]f（x）=\dfrac{1}{2}x^{3}-3x[/math]的零点？	如何找到[math]y=\frac{4x^2-36x}{x-9}[/math]的函数的零？	0
如何在我的Google play帐户上编辑我的设备？	如何将第二台设备添加到Google Play帐户？	0
我怎样才能成为一个好的演说家？	我该怎么做才能成为一个好的演讲者？	1
我怎样才能给纳伦德拉·莫迪先生写信？	我怎样才能给纳伦德拉·莫迪写信？	1
在总统大选中谁更有选举权：唐纳德·特朗普还是特德·克鲁兹？	谁更妄想：唐纳德·特朗普还是特德·克鲁兹？	0
他们为什么给杂种起名叫斯诺？	如果乔恩·斯诺不是内德的私生子，为什么凯特琳夫人这么恨他？	0
你觉得百慕大三角怎么样？	你对百慕大三角有什么看法？	1
墨西哥女孩喜欢黑人吗？	女孩喜欢没有胡子的黑人吗？	0
你住在小房子里吗？	你会住在小房子里吗？	0
男孩/女孩在1-6岁、6-11岁、11-14岁和14-18岁时叫什么？	我是一个18岁的男孩，我爱一个14岁的女孩。我们都住在泰米尔纳德邦。现在是向她求婚的时候吗？	0
你能在8个月大的时候给公鸡脱喙吗？	我应该给我3个月大的乌鸦喂多少和吃什么？	0
人们应该做些什么来克服焦虑？	我应该做些什么来避免抑郁和焦虑？	1
我们如何避免酸奶中的乳清？	口臭是肚子痛的征兆吗？	0
我爱上了我最好的双性恋朋友，他也是一个男人，有一个女朋友，我想告诉他。我如何继续前进？	我是个女孩，我爱上了我最好的朋友（她也是个女孩），我该怎么办？	0
德国最好的大学是哪所？	德国哪所大学获得机械工程学位最好？	0
我如何保持内心的平静？	我怎样才能保持内心的平静？	1
在印度哪辆车的构造质量好？	大众汽车是可靠的好汽车吗？	0
为什么按摩太阳穴可以缓解偏头痛或头痛？	偏头痛的病因和最有效的治疗方法是什么？	0
KMC Manipal和KMC Mangalore中哪一个更好？	Manipal和Mangalore的KMC的简要比较是什么？	1
为什么我最好的朋友仍然不理我？	当我最好的朋友不理我时，我该怎么办？	0
Acer Liquid Z630S安卓智能手机通过CPU-Z应用程序提供哪些传感器？	谷歌Play商店中没有哪些有用的Android手机应用？	0
我如何保持学习语言的动力？	当你学习一门新语言时，你如何保持动力？	1
印度的顶级评估公司有哪些？	印度和全球技能评估行业的顶尖公司有哪些？	0
@作为表情符号是什么意思？	表情符号：“/”是什么意思？	0
妊娠早期粉红色分泌物正常吗？是什么原因造成的？	尼古拉斯·皮拉马尔用17500铬做了什么？	0
正确地指出自己的最佳方法是什么？	在监狱里让自己开心的最好办法是什么？	0
科学家是如何工作的？	科学家在哪里工作？	0
CMC vellore的入围候选人中有多少人？	哈里瓦，帕坦加利办公室的办公室文化和工作是什么？	0
中国婚礼和西方婚礼有什么不同？	中西式婚礼有什么不同？	1
巴基斯坦的旅游业状况如何？	泰米尔纳德邦BE（EEE）学生首选PG课程？	0
离岸基金和在岸基金有什么不同？	海上和陆上的区别是什么？	0
为什么要憎恨沙鲁克汗？	为什么人们憎恨沙鲁克汗，为什么人们觉得他不是印度人？	1
你读过的最好的自助书籍是什么？	我应该读的最好的自助书籍是什么？	1
Evernote有用吗？	Evernote的用途是什么？	1
我继续接受博士的礼物的头衔？	我如何开始我的延续以获得博士的礼物？	0
什么是一首好歌来抒情恶作剧你最好的朋友？	有什么好的歌词恶作剧歌曲送给你最好的朋友？	1
我和女朋友争辩说她和那个对她有好感的人交了朋友。她说我是个控制狂，她想要她的自由。我该怎么办？	我是一个中学女生。我最好的朋友都是女孩。我发现我是双性恋。我该如何告诉我最好的朋友谁是女孩而不让她发疯，这会改变我们的整个友谊？	0
如何通过甲基苯丙胺药检？	染发剂能帮助每天吸食冰毒的人通过毛囊药物测试吗？	1
如何从开源开发开始？	我应该如何开始为开源项目做出贡献？	1
为什么梦看起来如此真实？	如果你梦见某种伤害，现实生活中会有伤害吗？	0
板球运动员真的在茶歇时喝茶吗？	板球运动员真的在茶歇时间喝茶吗？	1
我怎样才能进入麻省理工学院？	选择麻省理工学院的要求是什么？	1
胎儿在子宫内时会呼吸吗？	胎儿在子宫内如何呼气？	1
什么是乱伦电影？	有什么好的乱伦电影吗？	1
有什么迹象表明一个男人对你有感觉或对你有好感，但不想表现出来，所以他就隐藏了？	我约会的那个家伙从不给我发短信，我觉得他不在乎我，但当我看到他时，他向我表明他喜欢我，想要我。为什么我会有这种感觉？	0
根据国际机器人联合会的数据，2012年有多少机器人？	什么类型的皮带可以连续提升200公斤？	0
为什么奥伯伦在《仲夏夜之梦》中对泰坦尼克号发火？	为什么奥伯伦在《仲夏夜之梦》中惩罚泰坦尼克号？	0
你后悔离婚吗？	你后悔过离婚吗？	1
随着时间的推移，你的DNA会发生多大的变化？如果70年后我要克隆我自己，克隆人会有同样的头发颜色吗？	在大约70年的寿命中，一个人的DNA从出生到死亡能有多大的变化？	1
告诉一个女孩你对她的感觉对吗？	关于Facebook有哪些很酷的事实？	0
唐纳德·特朗普是否像霍华德·迪恩建议的那样服用可卡因？	有没有强有力的迹象表明唐纳德·特朗普吸食可卡因？	1
为了成为精英的一部分，或者仅仅为了富有和成功，你必须加入一个秘密组织，否则就没有机会了，这是真的吗？	ICSE 2017地理地图的教学大纲是什么？	0
哪一个在经济上更有利：在公司工作还是在建筑学院教书？	对于有抱负的企业家和大亨来说，为什么职业培训计划比大学学位更有益处？	0
我怎样才能看卡皮尔现场秀的喜剧之夜？	卡皮尔在片场现场观看喜剧之夜的方式是什么？	1
为什么sandeep maheshwari不在Quora上？	谁是Sandeep Maheshwari？	0
怪物猎人中最大的怪物是什么？	有怪物猎人的电脑游戏吗？	0
我怎样才能说服人们停止亵渎圣灵？	即使我的分数很高（99%+），你从哪所大学毕业（BCom）进入印度顶级商学院也很重要吗？	0
为什么我不能停止看色情片？	为什么我应该/不应该看色情片？	0
我怎样才能开始相信任何人？	如何才能再次学会信任？	0
你的遗愿清单是什么？	你的清单是什么？	1
在正常情况下，伊利诺伊州提供哪些汽车服务？与出租车相比，它们有多好，彼此之间有多好？	亚特兰大有哪些汽车服务？与出租车相比，它们有多好，彼此之间有多好？	0
为什么带电分子不能通过脂质细胞膜？	为什么钠通道不能通过钾通道？	0
作为一个著名色情明星的配偶感觉如何？	我怎样才能摆脱配偶欺骗我的感觉？	0
什么是最好的酒店预订会员计划？	Srm最好的非AC女生宿舍是哪家？	0
从布鲁克林到斯塔顿岛的车程如何描述？这些城市的旅游景点与皇后区的相比如何？	如何描述从布鲁克林到斯塔顿岛的车程，以及这些城市的旅游景点与其他旅游景点相比如何？	0
为了更健康，我每天可以吃什么？	每天吃一整块鳄梨健康吗？	1
我如何在安得拉邦的Airtel上给家人打免费电话？	如何在HTC 10上获得Facebook徽章通知？	0
既然选举已经结束，希拉里·克林顿会怎么做？	希拉里·克林顿现在将做什么？	1
我应该用Vicks Vapor Rub治疗鼻塞吗？	如何使用Vicks Vapor rub治疗鼻塞？	1
我如何开始准备教资会网络英语文学最新教学大纲？	我如何准备英语文学中的网络JRF？	1
在哥伦布交换之前，早期欧洲人是如何获得蛋白质的？	在咖啡被介绍给欧洲人&葡萄牙语之前，他们是如何用葡萄牙语说早餐的？	0
平面设计师的最佳论坛是什么？	谁是以色列最好的平面设计师？	0
亚历克斯·琼斯是一部讽刺剧吗？	《坎特伯雷故事集》是如何讽刺的？	0
如果我不懂打字脚本，我应该学习AngularJS 1.5而不是AngularJS 2吗？	我应该从哪个开始：Angular2还是AngularJS 1？	0
为什么有时候我们不能入睡？	为什么我们会睡着？	0
哪些惊奇漫画电影没有包括斯坦·李的客串？	在惊奇漫画电影中，你最喜欢的斯坦·李客串角色是什么？	0
你对莫迪政府取消500卢比和1000卢比纸币的决定有何看法？这将如何影响经济？	你对印度禁止发行500和1000卢比纸币有什么看法？	1
疯帽子上的10/6标签是什么意思？	你如何在教科书中找到这样标注的数字？	0
谁为孩子们写的卡丁车？	我是一名自由音乐家。我怎样才能进入叮当行业？	0
为什么盐水太妃糖是从希腊进口的？	为什么盐水太妃糖在中国进口？	1
进入麻省理工学院的最低要求是什么？	我怎样才能加入麻省理工学院？	1
你如何回答关于Quora的问题？	你在Quora中学到的最好的东西是什么？	0
以色列对伊朗：谁会赢？	如果以色列和伊朗开战，谁会赢？	1
什么时候学钢琴太晚了？	我快40岁了。对我来说学钢琴太晚了吗？	1
什么是自然数？	什么是最小自然数？	0
是一部支持3T和4G电压的手机吗？	买哪款手机Moto m或one plus 3t？	0
如何输入一个新的电子邮件ID以恢复我的Facebook ID？	我丢失了我所有的身份证。我是领养的，无法获得我的原始出生证明。我如何在没有出生证明的情况下更换身份证？	0
我们如何能以比光速更快的速度旅行？	有可能以比光速更快的速度旅行吗？	1
导致分布式平台/应用程序中数据不一致的因素有哪些？	主要的数据平台是什么？	0
在IPC中，POCSO和性犯罪之间有什么区别？	我们需要IPC第375节吗？	0
“是”这个词的替代词是什么？	创造性的替代词是什么？	0
在NBA，什么是非法屏幕？	沙奎尔·奥尼尔认为蒂姆·邓肯是一名大前锋，因此取消了邓肯参加NBA大人物讨论的资格。奥尼尔说得有道理吗？	0
再也没有什么能让我兴奋了。我怎样才能恢复那种兴奋？	当我没有什么好兴奋的时候，为什么我会觉得我对某件事很兴奋？	0
蝙蝠侠教给我们的人生课程是什么？	你可以从黑暗骑士身上学到什么？	1
你如何阻止罪犯绑架你，让你安然无恙地逃脱？	你如何阻止罪犯绑架你并安然无恙地逃跑？	1
如何在亚马逊上销售？	如何开始在亚马逊上销售？	1
丹尼尔·艾克：我们预计Spotify在印度什么时候上市？	丹尼尔·艾克：未来有没有在印度发布Spotify的计划？	1
一个人在20出头时应该读的前10本书是什么？	在20岁出头的时候，哪些书值得一读？	1
我应该从哪本书开始准备登机门？	我从哪本书开始准备登机门？	1
“不爱的人死了”这句话到底是什么意思？	“爱生爱”是什么意思？	0
什么与4Shared相似？	什么与4shared相似但更好？	1
如果有人触摸杂草，然后你握他们的手，然后用同一只手吃东西，你会兴奋吗？	如果有人用双手抓住你的衬衫，叫你闭嘴，那是袭击吗？你能报警吗？	0
考虑到当前信息技术的发展趋势，平面媒体的未来是什么？	这个模型叫什么名字？我到处都能看到她。	0
鸡肉比萨饼的最佳配方是什么？	哪些是好的比萨饼食谱？	0
在印度有哪些好的地方可以学习登山？	对于初学者水平的登山课程，有哪些好的登山机构？	1
新乒乓球会损坏橡胶吗？	如何用网球解锁汽车？	0
我的新Xbox one在安装过程中无法连接到internet。有什么解决办法吗？	我可以从某家银行的任何一家分行取款吗？我的银行是巴罗达银行，我没有Atm卡和支票簿？	0
我满足于自己的生活是不对的吗？	什么是封面故事？	0
重力只是一种理论吗？	根据M理论，共有11个维度。为什么星际空间中只有5个关于引力的维度？	0
当我的视力低于要求时，我怎么能成为战斗机飞行员？	我的视力很差。我还能成为空军的战斗机飞行员吗？	0
Infosys中的运营高管薪酬？	当我认为自己患有不宁腿综合征（不管怎样，我的腿在晚上会痛）时，我该怎么做清醒梦呢？	0
穴居人是否接受过科学测试？	神秘生物是否经过科学测试？	0
气候变化可以逆转吗？	全球气候变化能否逆转或停止？	1
我该怎么问我的心上人她的电话号码？	我该问我的爱人什么？	0
为什么我相信引力存在？	所有行星都存在引力吗？	0
摩诃婆罗多真的发生了吗？	《摩诃婆罗多》是真的发生了，还是仅仅是甘地的寓言？	1
国会能阻止总统发动一场大战吗？	购买律师电子邮件地址的好来源是什么？谢谢	0
一个月内减掉25磅安全吗？	一个月减掉13磅健康吗？	0
什么是可爱的首能ai系列？	神奇宝贝系列什么时候结束？	0
为什么警灯是红色和蓝色的？	为什么警灯是红色和/或蓝色？	1
如何发布标记为需要改进的问题？	为什么我的问题被标记为“需要改进？”	1
谁拥有自然？	谁拥有自然因素？	0
如何在Android上安装OBB/data文件？	我想在Android mobile中安装EXE扩展文件。可能吗？	0
什么是垃圾价值？为什么我们在c中得到垃圾值？	c中的垃圾值是多少？	0
我如何准备软件面试？	准备软件面试的最佳方法是什么？	1
中午是上午12点还是下午12点？	早上去健身房，中午去游泳好吗？	0
彗星和小行星有什么区别？	小行星和彗星有什么区别？	1
巧克力牛奶对你有好处吗？	为什么非冷冻牛奶对你有好处？	0
我应该怎样学习	有效学习的一些技巧是什么？	1
哪个国家最适合高等教育和工作？	除了美国和英国，哪个国家的高等教育最好？	0
这幅画上的画是什么？	这幅画是什么？	0
加利福尼亚州的主要公路有哪些？它们与田纳西州的主要公路相比如何？	加利福尼亚州的主要公路有哪些？它们与德克萨斯州的主要公路相比如何？	0
宇宙之外还有什么？	如果空间在扩大，新的空间从何而来？	0
头发的生长是物理变化还是化学变化？	秃头的人能把头发长回来吗？	0
文化和历史有什么区别？	不同文化的辣椒有什么不同？	0
一个男人说我喜欢你是什么意思？	男人说“安全”是什么意思？	0
什么使程序员“好”	什么使一个好的程序员伟大？	1
什么最有可能导致第三次世界大战？	第三次世界大战即将爆发吗？	0
美国总统大选后可能爆发内战吗？	美国是否在选举后面临某种形式的起义风险？	1
哪个欧洲国家最适合寻求庇护者？	举报人寻求庇护的最佳国家是什么？	0
麦田怪圈是在哪里产生的，又是如何产生的？	麦田怪圈是什么？	1
小苏打有助于通过尿检吗？	小苏打如何帮助你通过药检？	1
寨卡病毒是什么？它是如何传播的？	寨卡病毒是如何传播的？	1
自学代数最好的方法是什么？	你如何快速学习代数1？	1
在大学里重修一门课感觉如何？	大学重修科目会影响未来的工作前景吗？	0
Google Display Network是否要求任何站点在继续使用GDN之前先进行it SEO（页面内和页面外优化）？这可能吗？	我怎样才能从谷歌搜索的第一页上取下我的名字？	0
在一个基督教社区里假装“属灵”有多难？	为什么会发生阿金库尔战役？它与埃奇山战役相比如何？	0
什么是辐射对称花？	弗劳尔斯：什么是维亚尼？	0
什么地方最适合做爱？	做爱的最佳场所是什么？	1
贫血的人死得更年轻吗？	贫血会增加易怒吗？	0
2016年末，您对新款MacBook Pro有何看法？	我应该买新的MacBookPro吗？	1
睡觉时捂着头会导致大脑损伤吗？	酗酒会导致长期脑损伤吗？	0
中国文化和西方文化的主要区别是什么？	中西文化有什么不同？	1
什么是刮削技术？	哪些是好的免费网络刮板/刮板技术？	1
我29岁了。我有2型糖尿病。最近我的血糖水平增加到150（禁食）。我做运动，吃全谷类食物。为什么会这样？	我在哪里可以找到最好的安全摄像头？	0
每天吃蛋白健康吗？	每天吃一只鸡健康吗？	1
什么单词在Dictionary.com的难度指数中排名最高？	印地语单词能在牛津词典中占有一席之地吗？	0
为什么我根本感觉不到悔恨或同情？	为什么我不感到懊悔？	0
我每天应该做多少分钟的有氧运动？	一天能练多少分钟瑜伽？	0
如何治疗严重的脚扭伤？	我怎么会严重扭伤脚？	0
如何治疗颈部严重的痉挛？	颈部严重痉挛的症状有哪些？	0
推荐外国人到尼泊尔旅游的最佳地点是什么？	尼泊尔最好去哪些地方？	1
我应该由谁在笔记本电脑中激活skyrim的数据链路连接器？我在做了命令行之后，让它在我的电脑上工作，但在笔记本电脑上也做了同样的操作，没有用。。	我厌倦了我买的笔记本电脑在20年后变得又旧又慢。台式机退化的速度也一样快吗？购买固态硬盘笔记本电脑/台式机是否有助于延长其寿命？	0
我应该如何准备汇丰GLT安置测试？	我应该选择哪家公司，汇丰（GLT）还是Cybage软件？	0
有没有印度作家/作家使用过笔名？	唐纳德·特朗普错估了他的竞选对其“品牌”价值的影响有多大？	0
我如何注册为职业课程提供各种编程语言培训的学院，因为它将免除服务税？	我应该在SSC cpo中获得多少分数才能得到德里警方？	0
第三次世界大战有多迫在眉睫？	我们正在走向第三次世界大战吗？	1
你怎么写一首歌？	我怎么写一首歌？	1
取消货币流通后，纳伦德拉·莫迪的下一步行动是什么？	停止流通后的下一步是什么？	1
如果你有我，你想和我分享。如果你分享我，你就没有我。我是什么？	如果你有我，你想和我分享。如果你和我分享，你就不会理解我。我是什么？	1
什么是一个有趣的事实，你知道，我不知道，但不应该？	大多数人不知道的最有趣的事实是什么？	1
受控融合有什么问题？	为什么我们还没有开发出一种聚变反应堆，它能产生比消耗更多的能量？我们面临的问题是什么？	0
在哪里可以找到适用于android的3ds emulator？	是否有适用于PC的任天堂3DS模拟器？	1
我想在印度开一家服装精品店，从哪里可以买到便宜的批发服装？	哪里可以买到便宜的成批衣服？	0
我怎样才能成为一名真正的计算机科学工程师？	我如何成为一名优秀的计算机科学工程师？	1
在启动Android手机之前是否需要解锁引导加载程序？	ClockWorkMod如何适用于未解锁引导加载程序的手机？	0
什么是bss工程师？	在软件开发领域工作3年后，成为安卓开发者成为翻译人员是正确的选择吗？	0
当我把以色列和犹太教置于负面的角度时，为什么我会受到Quora主持人的惩罚？	我怎样才能在计算机科学和编程方面出类拔萃，而又不浪费四年在印度工程学院获得CS学位？	0
在清醒梦中你能做什么？	你的清醒梦体验如何？	1
美丽是什么感觉？	被许多人吸引和渴望是什么感觉？	0
有可能在第12届科学会后进行CA吗？	如果我通过了2016年TIFR GS笔试，我应该做些什么来申请政府机构的博士研究生奖学金？	0
我怎样才能破解别人的whatsapp帐户？	我如何破解另一个WhatsApp帐户？	1
在加州大学洛杉矶分校学习数学是什么感觉？	南加州大学能买加州大学洛杉矶分校吗？	0
人生最好的一课是什么？	你从生活中学到的最重要的一课是什么？	1
有哪些有趣的移动应用程序？	招聘人员最好的手机应用是什么？	0
特朗普的总统任期将如何影响计划在美国攻读博士学位的印度学生？	特朗普总统任期将如何影响在美的印度学生？	1
系列中有哪些蝙蝠侠电影？（按顺序）	蝙蝠侠的顺序是什么：阿卡姆游戏？	0
一个人可以用什么样的日常生活技巧使他的生活变得轻松？	日常生活中的难题是什么？	1
一个星期不吃东西能减轻多少体重？	每次吃东西后，我通过清理身体可以减轻多少体重？	0
ATM机是如何在内部工作的？	ATM交易是如何运作的？	0
每年有多少机械工程师从印度毕业？	印度每年有多少机械工程师毕业？	1
如何创建一家成功的私募股权公司？	你需要什么来创办自己的私人股本公司？	1
什么是最被低估的约会活动？	最被低估的活动是什么？	0
每一个机械工程师都应该知道的一些常识是什么？	所有机械工程专业的学生都应该知道什么？	0
三名成员（2-3天）游览喀拉拉邦最佳地点的中等预算是多少？	对于大学生来说，喀拉拉邦最适合游览的地方是什么？	1
为什么《Quora文摘》充斥着关于谷歌、智商和中国的问题？	为什么Quora上有那么多关于IQ的问题？	0
你将如何毁灭这个世界？	我怎样才能毁灭世界？	0
我如何从YouTube上赚钱？	我如何通过YouTube赚钱？	1
粒子和分子之间有什么区别？	如何完全关闭Golang的Sublime文本中的语法突出显示？	0
在Facebook上，如何添加共同好友？	我能看一份在Facebook上与我分享最多共同好友的有序名单吗？	0
俄罗斯总统弗拉德米尔·普京对他最亲密的朋友和家人来说是什么样的人？	普京什么时候成为公众人物的？他的“成名”是什么样的？	0
我如何重新开始写作？	我如何开始写作？	0
如果时间是因为大爆炸的发生而开始的，那么大爆炸怎么会因为没有时间开始而开始呢？	大爆炸是怎么发生的，当时还没有时间发生呢？	1
与单身相比，恋爱中的感觉如何？我们的生活在恋爱中会发生怎样的变化？	为什么分手后我一辈子都想单身？为什么我觉得我已经结束了这段严肃的关系？	0
我怎样才能从头开始准备公务员考试？	我应该什么时候开始准备公务员考试？	1
国外有哪些无创血糖监测系统？	印度有哪些无创血糖监测系统？	0
手淫和性在快乐方面有什么区别？	性和手淫在快乐方面有什么区别？	1
什么是“变化越大，保持不变”的意思？	为什么有些人相信生命以死亡告终？	0
如何在埃及开展太阳能业务？	我如何开始太阳能业务？	0
规格为2 GB DDR2@RAM、Intel Core Duo 3.5 GHz、NVidia GeForce GT 610 3gb DDR3的我的电脑能否运行刺客信条辛迪加和GTA V？	从现在起5到10年后，web方法会有未来吗？	0
你有什么通灵能力吗？	你有灵力吗？	1
我如何管理学习时间？	你如何管理工作和学习之间的时间？	0
XLRI的教学日历是什么？	在8年的差距之后，是否有可能给usmele第1步？	0
你对Urjit Patel担任RBI新任行长有何看法？	Urjit Patel是RBI管理者的合适人选吗？	1
你为什么想当总统？	你想当总统吗？	0
印度为什么与邻国没有友好关系？	印度与美国的关系如何。？	0
特朗普选民在乎他背弃了所有竞选承诺吗？	一旦特朗普的支持者意识到他不能或不会信守竞选承诺，他们将如何反应？	1
我可以边睡觉边学习吗？如果是，怎么做？	我如何在睡觉时有效地学习？	1
你能在欧洲的Playstation上玩亚洲Playstation 4游戏吗？	你能在欧洲Playstation 4上玩亚洲Playstation 4游戏吗？	0
我如何停止沉迷于色情？	我怎样才能停止看色情片？	1
为什么英国的工程和制造技能在60、70和80年代急剧下降，特别是与德国相比？	为什么英国在70/80年代的生活水平很差，但现在更好了？	0
毕业后我如何与机器学习研究人员合作？	本科生如何帮助机器学习研究？	0
iOS开发者的未来是什么？	截至2015年，iOS的发展前景如何？	0
生命的意义是什么？我们到底是为了什么？	你觉得生活的目的是什么？	1
我怎样才能成为男朋友？	一个女孩是如何找到男朋友的？	0
时间旅行怎么可能？	你认为时间旅行有可能吗？	1
一个人怎样才能得到一张更丰满的脸？	我该怎么做才能让脸更丰满？	1
对于25岁的我来说，开始从事摄影事业是否为时已晚？	我想在25岁开始我的摄影生涯。太晚了吗？	1
什么时候做爱最好？	什么时候是做爱的最佳时间？	1
我们能把钢和铝焊接在一起吗？	为什么钢和铝不能焊接在一起？	0
哪个YouTube视频的喜欢/不喜欢比率最高？	YouTube视频怎么可能有更多的喜欢/不喜欢而不是浏览量？	0
克什米尔问题的解决方案是什么？	谢里夫政府有可能解决克什米尔的冲突吗？	0
如果你在地上挖个洞，从另一边出来，会发生什么？	如果我沿着直线在地上挖一个大洞，当我到达地球的另一边时会发生什么？我的头还是脚会先露出来？	0
我们能创造自由能源吗？	我们如何制造自由能源？	1
我应该为网页设计做些什么？	什么是网页设计？	0
你听过的最有趣的高雅笑话是什么？	你听过的最有趣的笑话/故事是什么？	1
如何找到表型比率？	什么是表型比率？	0
为什么土星会使它所处的房子受益？	当你在听一个无聊的演讲时，为什么时间过得这么慢？	0
谁是最具学术资格的宝莱坞名人？	哪个宝莱坞名人有自己的飞机？	0
有线耳机和无线耳机在质量上有区别吗？若然，原因为何？	将BOSE耳机放在耳朵里和耳朵周围有什么区别？	0
哪些电影是每个人一生中至少需要看一次的？	你会推荐大家看什么电影？	1
第三次世界大战会发生吗？	第三次世界大战是否比预期的更为迫在眉睫？	1
在便秘期间吃李子有什么帮助？	吃李子有助于便秘吗？	1
您在2016年CSE prelim中对《荒漠化公约》问题的所有陈述都是正确的。虽然许多教练认为第二句话是错误的。？	你有没有被你的长辈告诉过任何居高临下的话来证明他们的观点？	0
如果我们从未意识到二进制数的价值并利用它来生产数字技术，今天的技术会是什么？	如果两次世界大战从未发生过，世界的技术是否会变得不那么先进？	0
投资石油和天然气的最佳方式是什么？	如果我想购买石油和天然气特许权使用费，最低投资是多少？	0
阿纳布·戈斯瓦米是印度人民党的支持者吗？	可兰经支持莫迪吗？	0
什么是学习NuGet的好来源？	什么是学习数学的好来源？	0
你如何形容一个有很多兴趣的人？	关于如何从积极的角度描述一个人，有哪些例子？	0
是否可以关闭大华摄像头上的指示灯？	当你飞到一个国家但他们拒绝你入境时会发生什么？	0
巴基斯坦支持恐怖主义的原因是什么？	巴基斯坦是否已成为全球恐怖主义的避风港？	1
我怎样才能阻止头发脱落？	我怎样才能阻止掉头发？	1
在你看来，有史以来最好的古典歌曲是什么？	有史以来最好的古典音乐作品是什么？	1
匈牙利的政治和政府有哪些不寻常的方面？	新加坡的政治和政府有哪些不寻常的方面？	0
目的是什么？	科学的目的是什么？	0
我该如何回应通过电子邮件解雇我的老板？	通过电子邮件解雇某人可以吗？	0
在北果阿有哪些便宜实惠的住宿选择？	果阿有哪些经济实惠的好去处？	0
还有其他类似Quora的网站吗？	有类似Quora的网站吗？	1
“家鸟”的反面是什么？	起飞的对立面是什么？	0
你怎么知道你的未婚夫爱你？	你最喜欢你未婚夫的哪些方面？	0
有人能给我解释一下如何用步骤解决这个问题吗？	有人能给我解释一下如何处理这个小问题吗？	0
我如何培养我的头脑？	我怎样才能增加我的心境？	1
数学谬误：2+2=5的证明有什么错？	如果2加2等于5，数学会发生什么变化？	0
如果我付清我注销的金额，是否有助于CIBIL得分？	如果我只支付最低到期金额，我的CIBIL分数是否会受到影响？	0
《霍比特人》应该被视为托尔金的经典作品吗？	托尔金作品中中土世界的正确、规范的拼写是什么？	0
日本人怎么看待马来西亚人？	马来西亚人怎么看待印度人？	0
哈基顿之旅容易吗？	我能带10个月大的宝宝去哈基敦的大本营吗？	0
对于初学者来说，学习C编程的好网站有哪些？	我们如何学习c编程？	1
最高法院在电影放映前播放国歌的决定会影响你的爱国主义吗？	你对最高法院决定在电影院强制播放国歌有什么看法？	1
如果美国有一位女性总统，她的丈夫会被称为第一绅士吗？如果希拉里当选，比尔·克林顿将被称为什么？	如果一位单身女性当选美国总统，她会有第一夫人还是第一绅士？	0
我如何通过印度教授开发的与电影制作和制作相关的在线网络和视频课程获得MOOC/E-learning？	我如何通过印度教授开发的与摄影相关的在线网络和视频课程获得MOOC/E-learning？	0
移动电话号码便携性最终将于5月3日开始。网络提供商真的同意这一点吗？	手机号码的便携性最终将在5月3日开始，包括转圈。网络供应商真的同意了吗？	0
为什么人们讨厌暮光之城？	为什么人们如此讨厌黄昏？	1
你认为帝国主义在印度次大陆和非洲留下了积极或消极的遗产吗？	从学生时代步入企业生活。感觉如何？	0
为什么C是最好的编程语言？	Lua和C，哪一种是嵌入式系统最好的编程语言？	0
如何提高我的英语口语能力？	我怎样才能提高我的英语口语。？	1
我怎么能和同性恋做爱？	我怎么可能是同性恋而不喜欢同性恋？	0
我正在从一所菲律宾学校转学到一所有美国课程（参加IBDP）的学校，该学校采用百分比平均分数制。我如何获得我的平均成绩？	我在加拿大安大略省的一所高中读十年级。我真的很想和一个来自欧洲的学生交换。有没有关于我该怎么做的想法？	0
我如何在生活中找到爱？	我如何找到我生命中的爱？	1
游泳和健身哪个选项更适合减肥？	每天能燃烧1000卡路里吗？如果是，如何进行？	0
有没有办法摆脱女性乳房发育症？	我怎样才能去掉男人的胸部？	1
沙特的哪一个支付网关用于从/向多家银行收取和支付款项？	在印度，哪些工作没有压力，相对容易找到，薪水不错，并且允许你追求其他兴趣的工作？	0
印度教寺庙背后有什么科学原因吗？	参观寺庙背后的科学原因是什么？	1
伊斯兰教要求（男性）割礼吗？	伊斯兰教允许割礼吗？	0
我在哪里可以为悉尼的照相馆服务获得超高质量的照片？	我在悉尼哪里可以得到专业的照相亭服务？	1
我怎样才能知道我在Instagram上向谁发送了好友请求？	如何在Instagram上发送好友请求？	0
我怎样才能控制我的愤怒？	一个人如何控制自己的愤怒？	1
什么是性别？	什么是性别剖析？	0
我怎么离开Quora？	你怎么离开Quora？	1
生的和熟的香肠可以冷藏多久？	如果冷藏，onigiri能保存多久？它怎么能保存得更久？	0
最好的智能手机小工具是什么？	哪些是最好的智能手机技术小工具？	1
在印度做一个隐秘的同性恋感觉如何？	在印度，同性恋是什么感觉？	1
我们可以在亚马逊交换角色吗？	TPM在亚马逊的作用有多重要？	0
什么使一杯好咖啡很棒？	一杯完美的咖啡是什么？	1
为什么Gayle Laakmann McDowell/careercup没有创建MOOC或编码训练营？	盖尔·拉克曼·麦克道尔是否打算出版更多的书？如果是，她在做什么？	0
什么是发酵？发酵的产物是什么？	什么是发酵产品？	0
你觉得我的短片《色变》怎么样？	你觉得我的短片怎么样？	0
印度和巴基斯坦之间是否应该为克什米尔开战？	为什么印度和巴基斯坦在克什米尔问题上发生冲突？	0
给你买食品券的最好方法是什么？	我在大学里怎样才能拿到食品券？	0
什么是真实世界中的封装和抽象示例，它们有什么不同，又有什么联系？	在现实世界中递归的一些例子是什么？	0
安卓应用程序的安全和保险有哪些处理方法？	如何找到android安全的最佳应用程序？	0
初学者学习手风琴最好的方法是什么？	如果我会弹钢琴，学手风琴有多难？	0
印度军队中初级领导人的角色？	印度军队的作用是什么？	0
你对取消500卢比和1000卢比纸币的决定有什么看法？	取消500卢比和1000卢比纸币的流通有什么用？	1
关于班加罗尔，最令人激动的事实是什么？	关于班加鲁有什么有趣的事实？	1
如果父母双方都有B+血型，孩子能有A+血型吗？	如果我父母都是B+血型，我能成为A+吗？	0
哪本书最适合Neet化学？	哪本书是NEET最好的化学书？	1
启蒙的本质是什么？	什么是启蒙？	0
为什么有这么多的问题贴到Quora上，却可以通过谷歌轻松回答？	为什么许多Quora用户会问他们可以在线查询的问题？	1
当我在攻读MBA时，如果面试官要求我销售钢笔或其他产品，我该如何回答？	如果你的面试官让你在他面前卖掉他的钢笔，你的答案应该是什么？	0
意大利通心粉汤有哪些很棒的配菜？	68.44%的产品通过了工艺规范。要通过，产品必须接近平均水平。68.44%代表多少标准偏差？	0
从印度到美国，你最多可以带多少黄金？	我们为什么不往东飞，从印度到美国呢？	0
如果我的预订状态为RAC，是否意味着座位已确认？	我的家庭票已从RAC改为CNF（已确认），我们所有人都有相邻的座位吗？在准备好图表之后？	0
一个新网站如何保护它的设计和用户界面免受抄袭？	设计漂亮用户界面的方法是什么？	0
我怎样才能提高我的技能？	我如何提高我的学习技能？	0
是否可以在AVR和覆盆子pi之间使用SPI？	Raspberry Pi和Intel Galileo有什么用途？	0
2016年哪部电影最好？	2016年你最好的电影是什么？	1
500和1000卢比纸币禁令会产生什么影响？	为什么中央政府禁止旧的500和1000卢比纸币，而发行新的500和2000卢比纸币？	1
哪些是最好的照片？	什么是好照片？	0
为什么学生离家出走？	为什么人们离家出走？	0
在C++中，什么是访问修饰符？	Java中的访问修饰符是什么？	0
你能分析历史，还是不科学？	诗歌可以学吗？还是“你有没有”之类的？	0
关于死后生活有什么有趣的理论？	既然有一些未经证实的例子，那么关于死后生活的真相是什么？	0
我需要再打一次破伤风针吗？	我需要打破伤风针吗？	0
光如何在重力作用下弯曲？	如果重力使光弯曲，光能使重力弯曲吗？	1
抬高你的裙子意味着什么？	剪裙子有哪些可爱的方法？	0
玛莎拉蒂每年在美国销售多少辆新车？	在过去的10年里，莲花是否真的在美国销售过汽车？	0
你如何向你在Quora上关注的人发送私人信息？	我如何在Quora上向其他人发送消息？	1
你如何训练有棕色斑点的白色斗牛犬？	我如何训练白色斗牛犬？	1
火鸡和鸡肉有什么区别？	为什么火鸡的肉比鸡肉颜色更深，味道更鲜美？	0
在Quora上有哪些最超现实的问题？	关于Quora最离奇的问题是什么？	1
IT和计算机科学工程有什么区别？	计算机科学和计算机工程有什么区别？	0
什么时候是做爱的最佳时间？	什么时候做爱最好？	1
我怎样才能咨询一个好的免费在线占星家？	有好的免费在线占星家吗？	1
为什么我们对每个人都不感到同情？	为什么我不想和任何人说话？	0
为什么兄弟讨厌姐妹？	为什么我们恨我们的姐妹？	1
下载卡那达电影的最佳网站是什么？	下载游戏的好网站是什么？	0
最可怕的死因是什么？	什么导致绞死？	0
什么是电信延迟？	WiFi延迟与有线以太网相比如何？	0
印度拉奥医院高级住院医师是否有教学经验？	我在攻读计算机科学学士学位。我在第七学期，不能通过基础编程课程。浪费了很多钱？	0
熊猫有哪些行为适应？	小熊猫有哪些行为适应？	0
纺织工程好吗？	纺织工程好不好？	1
生产速度最快的汽车是什么？	世界上最快的街道合法车辆是什么？	0
磁铁是如何制造的？	磁铁是由什么制成的？	0
A332的街道价值是多少？	什么是真正的价值？	0
作为FBI或CIA特工的资格是什么？	成为FBI探员需要什么？	0
2014年PC最好的操作系统是什么？	PC最好的操作系统是什么？	0
为什么印度东北部没有主要的电视频道？	世界上有多少个电视频道？	0
假设情景：我们的实际信用卡系统和银行系统以前从未存在过。今天，您将如何在互联网上实现数字货币？	新石器时代的一些发明是什么？	0
Quora如何快速将问题标记为需要改进？	为什么Quora会在我有时间给出细节之前将我的问题标记为需要改进/澄清？几秒钟之内…	1
我如何联系好黑客？	我怎样才能雇用黑客？	1
2016年最好的恐怖小说是什么？	2014年最好的恐怖小说有哪些？	0
你见过的最美的东西是什么？	有史以来最美丽的建筑是什么？	0
过上好生活最重要的事情是什么？	我为什么要活着？	0
生命的意义和目的是什么？	生命的确切意义是什么？	1
我15岁了，身高5英尺7英寸，体重50公斤，我该怎么做才能增加体重？	我22岁，体重46公斤，身高5.4英尺。我该怎么做才能增加身高和体重？	1
为什么盐水太妃糖在中国进口？	为什么老挝进口盐水太妃糖？	1
在墨西哥城从美国预订房间时，网上的价格是否与亲自预订的价格不同？	为什么墨西哥城很危险？	0
为什么Venuetastic失败了？	预订一个好的婚礼场地要花多少钱？	0
对于Cortana、Siri或Amazon Echo，您得到了哪些最令人惊讶的回答？	理论物理学家给出的一些最令人惊奇的概念中有哪些是无法在现实中证明的，或者是过于先进而无法用现有资源/技术证明的？	0
人生最重要的是什么？金钱还是价值观？	金钱和尊重更重要的是什么？	0
谁是印度最好的黑客？	谁是最好的印度黑客？	1
印度的教育体系应该改变吗？	我们需要改变印度的教育体系吗？如果是，为什么？	1
空心柱的多种用途是什么？	建筑柱的标准尺寸是多少？	0
哪些是常见的发音错误的单词？	最常见的英语单词发音错误是什么？	0
为什么每个十几岁的女孩都迷恋她的数学老师？是智力还是他们的行为？	女生会迷恋男老师吗？	0
去医学院当医生是否太晚了？	24岁上医学院太晚了吗？	1
在Chatswood West哪里可以买到质量最好的商用innerspring沙发床？	在Chatswood，我在哪里可以获得清洁油漆和去除油漆的优质服务？	0
如果你截取了某人的Instagram视频，他们会收到你截取的通知吗？	如果我在Instagram上截取某人的实时视频，他们会得到通知吗？	0
除了大门外，计算机科学专业的大四学生还能参加哪些政府考试？	除了大门外，计算机科学专业学生最后一年的平均成绩还能参加哪些政府考试？	1
什么句子使用全部26个字母而不重复？	Pangrams：在英语中，只使用一次字母表中的所有字母，然后选择一本词典，你能造出一个句子，或任何一组常用英语单词吗？	0
大脑顶叶白质低密度的影响是什么？	如何增加大脑中的灰质？	0
你的工作和薪水是多少？你对目前的工作满意吗？	我的智商目前是83。我能得到一份高薪的工作吗？还是能得到一份六位数薪水的工作？	0
精神病患者：你觉得婴儿可爱吗？	精神病患者觉得婴儿可爱吗？	1
恐怖电影用的带唱诗班的歌剧歌曲是什么？	歌剧合唱团的权利是什么？我们彩排有报酬吗？我们是否有权在整个排练等过程中提供餐饮服务（歌剧院的一部分）？	0
天主教会的女性会因为与牧师发生性关系而被回避或排斥吗？	如果一名妇女起诉天主教会不允许她们成为牧师，会发生什么？	0
如果一个加拿大人在美国纹身，他们返回加拿大时需要申报费用吗？	我是一名刚在美国完成学业的加拿大公关。我得到了一份H1-B。我应该接受这份工作还是返回加拿大？	0
我怎样才能看到谁在Facebook上阻止了我？	我能看看是否有人阻止我访问Facebook吗？	1
为什么高质量的奇幻电影稀缺？	简要描述您将如何测试矿物的这些特性？	0
泰米尔纳德邦的一些伟大的程序员是谁？	泰米尔纳德邦有没有有竞争力的编码员？	1
当你听到“选举”这个词时，你会怎么想？	当你听到“日本”这个词时，你会怎么想？	0
2017年学习哪种编程语言最好？	你应该如何开始学习编程？	0
为人类服务的终极方式是什么？	如何为人类服务？	1
从现在算起72小时怎么算？	如何计算ITER中SGPA的学期百分比？	0
吉米·威尔斯移民到英国有多难？	为什么吉米·威尔斯选择住在伦敦而不是美国？	0
Cochin到伦敦etihad在迪拜1小时的换车时间是否足够？	中国和美国送礼物有什么区别？	0
Quora对单个问题的答案进行排序的算法是什么？	Quora上答案的排名是如何工作的？	0
2016年的决议应该是什么？	你2016年的目标是什么？	1
巴拉吉·维斯瓦纳坦对印度基于种姓的保留地有什么看法？	巴拉吉·维什瓦纳森对印度基于种姓的保留制度有何看法？	1
下巴哈比卜发型价格？	你认为如果我的树倒在你的财产上，应该是MYINE还是你的责任？	0
有人有雷恩和马丁·格拉默的答案和作文的电子书吗？	为什么巴伐利亚加入德国？	0
如果[math]x+\left（\dfrac{1}{x}\right）=0[/math]，那么[math]x[/math]是什么？	什么是[数学]\mathop{\lim}\limits{x\ to 0^+}\frac{1}{x}^\frac{x}{x+1}[/math]？	0
无论何时，只要是关于“她”的，都是一种非常特别的感觉。试图忘记她，但她一直都是间谍。我应该停止和她说话吗，即使是作为朋友？	我怎么才能不去想别人呢？	0
什么是共同基金？它们是如何工作的？	共同基金是什么？	1
随着时间的推移，脊柱解剖结构发生了怎样的变化？	计算子弹旋转时；MV X 12（以英寸为单位的扭转率）X 60=转/分，到目标的距离是否重要？	0
哪把低音吉他最好？	你是如何维护低音吉他的？	0
美国哪些大学在管理信息系统课程中提供更多的管理内容？	美国哪些大学在管理信息系统课程中提供了更多的技术内容？	0
我的数学非常差，我在12班。我怎样才能提高我的数学水平，以便明年通过JEE考试？	我想做工商管理学士。我在12班（非数学）只得了62%。我正在参加共生、GGSIPU等的入学考试，明年我是否也应该提高？	0
在函数式编程的上下文中，“函数”是什么？	什么是函数式编程？	0
社会主义和共产主义的主要区别是什么。？	社会主义、马克思主义和共产主义有什么区别？	1
如何更改我的Facebook密码？	我如何在没有密码的情况下登录Facebook？	1
“valiant”这个词在句子中是如何使用的？	“扭曲”一词在句子中是如何使用的？	0
为什么我在玩一些3D游戏时会感到头晕，而其他游戏却不会让我有这种感觉？在开发3D游戏时有什么技巧可以避免这种情况吗？	3D Rad：如何制作基于任务的游戏？	0
工资公司如何赚钱？	公司如何赚钱？	0
你看过的最被低估和高估的电影是什么？	最被高估的电影是什么？	0
对于哪些用例，您认为深度学习和神经网络在实践中效果更好，模型更简单？	在深度Q学习中，我们如何更新神经网络中的权重？	0
学习哪一个，C++还是C？	我应该首先学习：C++还是C？	1
如果我骑自行车，Fitbit会准确跟踪我的活动吗？	目前市场上最适合活动的可穿戴物品是什么（即颌骨或Fitbit）？	0
历史上耶稣的最好证据是什么？	支持和反对历史上耶稣存在的证据是什么？	1
哪些免费的在线语言课程可以让我从0到流利地学习葡萄牙语？	建议我一些提供证书的免费在线课程？	0
PM和Prez是如何获得女性的？	我工作了1个月，在担保期内从埃森哲潜逃。他们会采取任何法律行动吗？在加入其他公司时会生效吗？	0
什么是最好的兼职工作，你可以在家工作，并赚取一些好的现金？	在家里能做的薪水最高的兼职工作有哪些？	1
特朗普有机会赢得总统宝座吗？	特朗普赢得选举的可能性大吗？	1
如果我把工作从电子商务转到云计算怎么办？	如果我想加入一家基于产品或电子商务的公司，我应该参加哪些计算机科学课程？	0
我怎样才能见到苏雷什·雷娜？	我怎么认识苏雷什·雷娜？	1
在马杜里·迪克西特和兰比尔·卡普尔身上拍摄的这首歌的名字是什么，是哪部电影的？	萨尔曼·汗用弹弓戏弄马杜里·迪克西特的那首歌叫什么名字，是哪部电影的？	0
核质在植物细胞中的作用是什么？	植物细胞中心体的功能是什么？	0
化石记录可以作为进化的证据吗？如果是，怎么做？	化石记录提供了哪些进化证据？	1
什么是真主党运动？	葛兰运动是什么？	1
CAT考试和MAT考试能否在同一天（2016年12月4日）进行？	是否有必要学习吠陀数学并花时间在2016年cat考试的小技巧上？	0
圣经中有什么神秘的生物？	神话生物吃什么？	0
哪一个好：口交、肛交还是阴道性交？	我们进行了自愿的性行为，然后他强迫我进行肛交。如果我提出指控，我同意阴道性交的事实会毁了我的案子吗？	0
哦，辛辛那提的冬天天气怎么样？	特拉维夫冬天的天气怎么样？	0
现在最好投资哪些股票？	目前最适合长期投资的股票是什么？	1
我们如何提高儿童的阅读技能？	如何提高我的阅读技巧？	0
你腹泻时会失去营养和热量吗？	每天吃2000卡路里能让我减肥吗？	0
美国国家步枪管理局（NRA）在阿拉斯加提出了哪些处理散弹枪的安全预防措施？	美国国家步枪管理局在亚利桑那州提出了哪些处理猎枪的安全预防措施？	1
每天早上散步有什么好处？	宝莱坞产业不鼓励外来者？对于前局外人来说，他们可能有一次或最多两次机会，而明星儿童则有多次机会表演？	0
有没有后来开始成为冠军的武术家？	在电视上向人民法院提起小额索赔案的利弊是什么？	0
我怎样才能找回我的前男友？	我该如何让我的前任重归于好？	1
我应该选择哪个框架进行跨平台移动开发？	在为企业开发移动应用程序时，我应该选择什么跨平台？	0
我怎么知道网上约会的女孩是不是真的活在我身边？	我怎么知道我的网络女友是否真的爱我？	1
游戏编程的哪个领域在数学方面涉及最多，最适合数学专业？	如果一个人开始学习Python，以便能够将它应用到他的研究领域（主修化学，辅修数学），那么在申请工作时，Python的哪些应用程序最有用？	0
盗窃和抢劫有什么区别？	“入室盗窃”和“抢劫”这两个词有什么区别？	0
图论是机器学习的先决条件吗？	图论是机器学习的好课程吗？	0
印度学习自然语言处理的最好学校是什么？	学习自然语言处理的最好学校是什么？	0
特德·克鲁兹的支持者会投票给唐纳德·特朗普吗？	唐纳德·特朗普会支持特德·克鲁兹担任总统吗？	0
什么是GDP？	GDP的意义是什么？	1
美国总统是否有“盲目信任”条款？该条款是如何执行的？	谁将成为美国新总统？为什么？	0
我怎样才能让一个刚加入我大学三年级的女孩爱上我？	你要做什么才能成为一名飞行员？	0
痔疮或肛裂的家庭治疗方法是什么？	我如何用家庭疗法永久治疗肛裂？	1
GRE考试实际需要学习多少单词？准备GRE考试的正确方法是什么？	我怎样才能在GRE考试中取得最好成绩？	0
灵魂是不朽的吗？	为什么灵魂是不朽的？	1
你个人在第三宫的一些故事和经历是什么？	你个人在木星第一宫的故事和经历是什么？	0
如何减少印度的污染？	印度减少污染的最好办法是什么？	1
印度的政府责任合法吗？	优步在印度合法吗？	0
“我要拉屎”是什么意思？	“我喜欢你”是什么意思？	0
在海得拉巴庆祝2017年新年的最佳地点是什么？	在海得拉巴，哪一个是庆祝2015年新年的最佳地点？	0
什么是努力工作（不是学习）？	什么是努力学习？	0
我可以将Windows 32位升级到64位Windows 8.1吗？	我有32位的Windows7。我可以升级到64位Windows 10吗（因为这是免费升级）？	0
你一生中有哪些不好的经历？	你有哪些好的和坏的生活经历？	1
廷巴兰为什么出名？	Timbaland使用哪种牌子的鼓？	0
你能得到个人电话号码的清单吗？	你是如何得到手机号码的？	1
你必须在REM睡眠中醒来才能记住你的梦吗？	你需要在快速眼动睡眠中醒来以记住你的梦吗？	1
什么是农业的公共必修课和选修课？	哲学的公共必修课和选修课是什么？	0
我怎样才能学会唱歌？	我想学唱歌。我怎么开始？	1
谁有能力结束谷歌在搜索领域的垄断？	谷歌在网络搜索领域的虚拟垄断会结束吗？什么时候	0
自身免疫疾病会导致失眠吗？	什么导致自身免疫疾病？	0
GTA IV在Windows 7中工作吗？	GTA IV在Windows 10上工作吗？	0
哪个是昌迪加尔最好的SSC和银行培训机构？	在昌迪加尔，哪个机构提供最好的SSC和银行指导？	1
班加罗尔哪家是最好的PMP认证课程提供商？	班加罗尔最好的pmp认证中心是哪个？	1
净收入和总收入的区别是什么？	总收入和净收入之间的区别是什么？	1
我怎样才能在早上早起？	我怎样才能早上起得早？	1
你为什么爱她？	你喜欢什么？为什么？	0
我错过了IIT。我该怎么办？	我应该预计何时加入埃森哲，时间表显示2016年12月24日，我还没有收到该组织的任何更新？	0
iPhone 6s和iPhone 6s Plus有什么区别？	iphone6和iphone6s有什么区别？	1
如何将信用评分提高100分？	如果第二次世界大战的美军和越战的美军发生战斗，哪支军队会获胜？	0
我的爱人喜欢我回来；我们现在该怎么办？	我妹妹告诉我的心上人我喜欢她，而我没有要求她这么做。我现在该怎么办？	0
除了奥杜因，谁是天空边缘中最强大的角色？	谁会从Skyrim或Kylo ren那里赢得Dovahkiin？	0
穆斯林男人能和非穆斯林女孩约会吗？这是基于个人的宗教信仰还是其他因素？	非穆斯林对穆斯林有什么期望？	0
你对这张照片有何评论？	我可以对我女朋友的照片发表什么评论？	0
下雨时道路什么时候最滑？	下雨时，我应该做些什么来预防道路积水？	0
你如何通过实验证明海森堡测不准原理？	证明海森堡测不准原理最简单的方法是什么？	0
雅思考试是关于什么的？	什么是雅思及其用途？	1
不做任何运动我如何减肥？	我如何在不做运动或节食的情况下减肥？	1
为什么数码相机有快门声？	什么数码相机有电子快门，可以设置为绝对没有声音或噪音？	1
和歹徒约会是什么感觉？	我51岁了我能和30多岁的男人约会吗？	0
第一次世界大战的主要和最重要的政治原因是什么？	第一次世界大战的起因是什么？	1
我如何克服对一切的恐惧？	我如何克服恐惧？	0
印度哪个城市的天气最好？	阿根廷哪个城市的天气最好？	0
用外行的话说，HDD和SSD有什么区别？	SSD和hdd之间有什么区别？	1
如果一只狗吐出白色泡沫，这意味着什么？	为什么我的小狗吐白色泡沫？	1
我的生活对世界/宇宙有什么意义吗？	我们真的有什么人生目标吗？还是我们创造了一个目标，让自己在这个浩瀚的世界中感到有意义，或者让自己觉得我们需要在这个浩瀚的世界中生存？	0
我将如何开发电子商务网站？	如何创建电子商务网站？	1
如何从iPhone4中取出微型SIM卡？	iPhone4是否使用micro SIM卡？	0
我能做些什么来改进我关于Quora的问题？	我所有关于Quora的问题都需要改进。问Quora问题的最佳方式是什么？	1
如果其中一个人抓住了感情，在一个有利益关系的既定朋友安排中，我们怎么能放弃这种感情呢？	在这个我们不断看到别人工作和生活中最好的时代，我们怎么能不对自己的工作和生活感到不满呢？	0
对于那些试图自学唱歌的人，有什么建议？	我怎样才能教自己如何唱歌？	1
如果气候变化科学家是对的，为什么他们如此担心公共关系和包装？	在美国，如果一个男人和一个比他小30岁的女人约会，他会得到什么样的粗鲁评论？	0
印度所有问题的主要原因是什么？	如果弗朗西斯·法默（女演员）今天还在，她会怎么看待唐纳德·特朗普？	0
在通心粉和奶酪中，什么是牛奶的好替代品？	哈瓦蒂奶酪有哪些好的奶酪替代品？	0
便秘怎么会导致头晕？	便秘会导致头晕吗？	0
有没有可能制作一个医生点评应用程序，让患者可以匿名分享该医生提供的所有治疗、建议药物，？	Mi入耳式耳机Pro的保修期是多久？	0
希拉里·克林顿担任总统有哪些利弊？	希拉里·克林顿的优点和缺点是什么？	1
在一个房间里拍的最好的电影是什么？	我想激动一下。我应该看哪部电影？	0
如果你的精子在射精过程中没有射出，这正常吗？	我如何确保射精后精液不会从我的阴茎中流出？	0
昌迪加尔哪一个是最好的SSC和银行培训中心？	昌迪加尔最好的SSC和银行培训中心是什么？	1
系列1,1,1,2,2,6,6,6中的下一个数字是什么？	序列中的下一个数字是什么-2,15,4,12,6,7。。。？	0
万圣节最好做什么？	我们需要什么才能拥有最好的万圣节？	1
我希望开始投资股票和共同基金。我应该在哪里开立Demat账户以获得最佳利率、交易费用等？我是NRI。	我17岁了，我想投资股票市场，我应该从哪里开始？	0
兑换500和1000卢比纸币如何结束印度的黑钱？	你认为废除500卢比和1000卢比的面额会根除腐败吗？	1
我应该主修什么专业（大学）才不会让我失业（除了工程、法律、医学）？	在小组讨论中，如果其他人一直在吵架，甚至在我要求他们让我发言后也不让我发言，我该怎么办？	0
印度最好的定制信息亭制造商是谁？	谁是印度最好的定制信息亭制造商？	0
是否有足够强大的望远镜来观察NASA登月留下的证据？	我们现在是否有足够强大的望远镜，可以看到阿波罗任务遗留在月球上的人造物体，100%证明人类确实在那里着陆？	1
世界上任何地方都有建筑群/中心/论坛/中心吗？作为第三个空间。	是否有在线软件可用于计算Big O中Java程序的时间和空间复杂性？	0
最新版本的AutoHotkey脚本编程语言中有多少关键字？	最新版本的AutoIt脚本编程语言中有多少关键字？	0
在乌克兰抚养孩子最困难的事情是什么？	在墨西哥抚养孩子最困难的事情是什么？	0
网上学习股票市场的最佳来源是什么？	什么是最适合你的视频制作演示软件（付费和免费）？	0
为什么印度破坏和诋毁其邻国在世界上的所有经济项目？	为什么印度总是破坏和诋毁巴基斯坦与世界其他国家的所有经济项目？	0
湿阴道对男人来说是什么感觉？	为什么我觉得阴道里有个球？	0
周四晚上的足球会提高CBS在周四晚上的收视率而不是大爆炸理论吗？	为什么《生活大爆炸》这么受欢迎？为什么它如此受主流观众欢迎？	0
我17岁怎么才能长高？	你怎样才能增加你的身高？	0
你被解雇过吗？	你被解雇过吗？你是怎么处理的？	1
我到底该怎么穿得像1990年夏天的健身男？	我将如何打扮成1990年夏天的健身大师？	1
我女朋友不再跟我说话了。我该怎么办？	我女朋友没有和我说话。我该怎么办？	1
在500强和1000强之后，房地产现在会是什么样子？	废除500卢比和1000卢比纸币将如何影响印度的房地产业务？	1
问过的最好的面试问题是什么？	最好的面试问题是什么？	1
我很快信任别人，结果总是被背叛？我有什么不信任的人，仍然保持简单的关系？	在被别人背叛后，你认为相信别人足够明智吗？	0
孟买最好的猎头是谁？	谁是最好的猎头？	0
狗用DHP疫苗的用途是什么？有必要吗？	人类狂犬病疫苗能用于狗吗？	0
亚洲和非洲有什么不同？有什么相似之处？	索道和索道的区别是什么？	0
巫师的魔法经过科学测试了吗？	法师是否经过科学测试？	1
为什么合同法很重要？	为什么海商法如此重要？	0
moto G3（2015年第三代moto G）将于何时更新Android 7.0（牛轧糖）？	我将在moto g3上获得多长时间的操作系统更新？	0
证明功率的信噪比=（电压的信噪比）Sequale？	当你在JRE上与同伴打架时，你会得到报酬吗？还是仅仅为了娱乐/曝光？	0
蝙蝠侠的最佳谜语是什么？	谁是诺兰蝙蝠侠电影中最好的反派？	0
《权力的游戏》中为什么有这么多裸体内容？	为什么《权力的游戏》电视连续剧中有这么多裸体镜头？	1
如何在我的博客上获得关注者和评论？	我怎样才能在我的博客上获得更多的关注者？	1
我只有2个月的时间参加CA CPT考试，我该如何准备？	我想在两个月内完成CA CPT。我应该怎样学习？	1
如果我想玩2D MMORPG游戏，我应该学习什么编程语言？	如果我想开发游戏应用程序，我应该学习哪种编程语言？	1
你对印度最近的货币废止有什么看法？	你对人民币的非货币化有何看法₹500 & ₹印度有1000张钞票？	1
为什么塞勒斯·米斯特里被除名了？	为什么塔塔之子将塞勒斯·米斯特里替换为拉坦·塔塔？	1
你们如何取消美国汽车保险公司的汽车保险？	加州的汽车保险经纪费？	0
为什么我最近这么生气？	我为什么这么生气？	0
既然你还没有做过任何测试，也没有任何测试结果，你如何形成一个假设？	为什么在任何领域取得硕士学位的人都建议你不要取得硕士学位？	0
拖拉的后果是什么？	停电的后果是什么？	0
我害怕Arvind kejriwal，他可能会杀了我，我该怎么办？	出售比特币和接受信用卡支付的风险是什么？	0
与其他品牌相比，苹果电脑/笔记本电脑有哪些缺点？	为什么美国有这么多人拥有苹果品牌的手机或笔记本电脑？	0
你一生中记得的第一刻是什么？	你一生中记得的第一件事是什么？	1
完成BDS后我可以做什么？	完成BDs后我们可以做什么？	1
所有的穆斯林都恨纳伦德拉·莫迪吗？	为什么穆斯林憎恨莫迪政府？	1
我18岁了。我该怎么办？	我18岁时能做什么？	1
什么是真正好的和著名的浪漫喜剧电影？	最好的浪漫喜剧电影是什么？	1
作为持有第一个会计学士学位的国际学生，获得第二个数学学士学位有多现实？	一只被饲养到4岁（人类年龄）的幼狮如果能在野外放生，还能活下来吗？	0
怎么可能相信旧约中只有一位神，同时又相信三位一体呢？	寻找6位adc的实际应用？	0
我应该如何开始冥想？	我应该如何开始冥想，何时开始？	1
膨胀能产生无限量的暗能量、真空能量或引力能吗？	真空能、虚粒子和/或暗能量的势能是无限的吗？不合并	1
比哈尔邦真的是在马哈格班汉·萨卡尔的领导下发展的吗？	比哈尔邦是否在首席部长尼蒂什·库马尔的领导下发展？	0
顺势疗法药物怎么可能没有副作用？	顺势疗法药物的副作用是什么？	0
你如何确定什么是好的投资经纪公司，什么不是？	5000卢比以下的最佳音乐播放器是哪一个？	0
印度供应链管理的范围是什么？	采购、物流、运营和供应链管理的未来范围是什么？	0
活塞的数量是否等于气缸的数量？	我如何加入维基解密？	0
我们能在梦中控制自己的行为吗？	我们能控制我们的梦想吗？我们能梦想我们想梦想的吗？	1
你是如何处理好远距离关系的？	远距离关系如何才能成功？	0
我向富人索要一百万美元并让他们给我的机会有多大？	我26岁了，刚赚了400万美元。我的目标是40乘35。我是否错误地认为生活在这个国家最昂贵的地区会给我更好的机会？	0
香港电影和电视剧发生了什么？他们为什么下降这么多？	英国脱欧发生后，英国公民会被允许移居欧盟并在那里居住吗？	0
特朗普赢得选举了吗？	唐纳德·特朗普有可能赢得即将到来的选举吗？	1
iPhone上最好的壁纸应用是什么？	最好的iPhone壁纸是什么？	0
如何停用应用程序“应用程序锁定”？	如何在Android手机中恢复应用程序锁保险库中的照片？	0
我应该以什么格式发送书籍进行打印？	在线考试中心业务？	0
为什么种姓制度在印度仍然存在？	为什么印度在独立70年后仍存在种姓制度？	1
我怎样才能在13岁时找到男朋友？	我13岁的时候怎么找男朋友？	1
2016年NEET的550分排名是多少？	如果我的分数是391，那么我在2016年NEET的排名是多少？	0
动态/灵活定价是否对中产阶级苛刻？	SEO或SMO有助于获得更多业务？	0
我可以透支我的富国银行账户吗？	富国银行的透支政策是什么？	0
语言学校有哪些新的营销技巧？	语言学校的营销技巧是什么？	1
奥运金牌获得者挣多少钱？	奥运金牌得主在中国能挣多少钱？	0
网上赚钱的简单方法是什么？	我如何在网上赚钱？	1
电容器的电抗是多少？	电容器电抗背后的原因是什么？	1
SV和湾区的生活成本如此之高，以至于收入超过15万英镑的新毕业生很难找到负担得起的住房，这是真的吗？	亚马逊是否降低了硅谷等生活成本高的地区的生活成本？	0
世界上最好的学校是什么？	世界上学习电影最好的学校是什么？	0
为什么盐水太妃糖在澳大利亚进口？	为什么盐水太妃糖从奥地利进口？	1
0的值是多少？	为什么零阶乘（0！）等于一（1）？	0
班加罗尔最好做哪些兼职？	在班加罗尔我们能做的最好的兼职工作是什么？	1
我怎样才能成为一个有魅力的女孩？	你如何变得漂亮/有魅力？	1
有史以来最好的音乐专辑是什么？	什么被认为是最好的音乐专辑？	1
现实地说，如果唐纳德·特朗普在2016年选举中当选总统，美国会发生什么？	唐纳德·特朗普为什么得到如此多的支持？如果他赢得选举会发生什么？	1
儿童自闭症的症状是什么？	女孩自闭症的症状是什么？	0
做一个不吸烟的母亲，带着吸烟的孩子，感觉如何？	身为吸烟孩子的无烟妈妈是什么感觉？	1
没有梦想的生活是什么？	生活是梦想还是现实？	0
以8万美元的薪水，我在华盛顿特区能过得舒服吗？	我能以80000-114000美元的薪水在华盛顿舒适地生活吗？	1
你怎么知道一个女孩是否有男朋友？	我如何判断一个女孩是否有男朋友？	1
红扁豆对健康有什么好处？	吃鳄梨有什么好处？	0
第十班的数学相关工作模型是什么？	我怎样才能做一个数学工作模型？	0
我怎样才能以健康的方式增加体重？	我怎样才能获得健康的体重和体重？	1
这是什么动物干的？	你是什么动物？	0
阿尼尔·安巴尼如何从拉菲尔战斗机交易中获益？	网上购买更多的是什么？	0
YouTube Red的离线功能和下载视频本身一样好吗？	在第7章之后，是否仍有可能获得良好的信用评级？	0
我怎么知道我的配偶是不是我的灵魂伴侣？	我怎么知道他是我的灵魂伴侣？	1
我怎样才能成为一个有人情味的人？	我应该怎样做一个有人情味的人？	1
异地恋是如何运作的？	远距离关系有效吗？	1
我怎样才能说一口流利的英语？	我怎样才能听懂英语？	1
考虑到你作为国务卿的地位让你对美国的无人机计划有了深入的了解，你将如何改革瞄准过程？	作为国务卿，你最大的挑战是什么？	0
MIKE2.0到底是什么（用外行的话说）？	用外行的话说，框架到底是什么？	0
为什么水牛之类的动物不进化成一起对付狮子和猎豹而不是逃跑呢？	okha express提供食物吗？	0
我在哪里可以找到有正当理由的黑客？	我在哪里可以找到一个好的黑客？	1
如何更改snapdeal帐户的手机号码？	如何更改星展银行账户的注册手机号码？	0
在科技银行面试过程中有哪些技巧？	在at&T的面试过程中，有哪些技巧？	0
委内瑞拉的主要进出口是什么？委内瑞拉的工业与古巴相比如何？	委内瑞拉的主要进出口是什么？委内瑞拉的工业与玻利维亚相比如何？	0
卢载旭和加布里埃是如何相处的？	中情局、国家安全委员会和其他相关组织的角色在现在和过去有什么不同，有什么关系？	0
有什么好电影可以看？	最好看的电影是什么？	0
如何在iOS 9.3.5上安装Cydia而不越狱。？	你能在你的设备上下载Cydia而不越狱吗？	0
我怎样才能在微软找到工作？	我如何在谷歌或微软找到工作？	1
为什么“华氏451”被视为反乌托邦？	华氏451度（1953年出版）：盖伊·蒙塔格的名字是什么？	0
你对《思想中的爱》（2004年电影）有何评论？	你对《岩石上的爱》（2004年电影）有何评论？	0
在物理上是否有可能回到过去？	有可能在时间上来回旅行吗？	1
为什么我只对某些人感到尴尬，而对其他人却不尴尬？	为什么夏天有海风，但冬天很少？	0
如何恢复Facebook中已删除的邮件？	如何恢复已删除的Facebook消息？	1
优步的薪酬体系如何？	客户服务：优步的电话号码是多少？	0
Flipkart在借记卡上提供EMI是否可行？涉及的不同因素有哪些？	有没有办法通过Flipkart在EMI上只使用借记卡购买手机？怎样	0
我如何在敏捷scrum方法中定义任务、里程碑和交付物？	什么是敏捷和Scrum模型？	0
生活可能很无聊。怎么办？	我的生活很无聊。我能做什么？	1
在加拿大哪里可以买到meldonium？	在美国哪里可以买到meldonium。？	0
自杀的好方法是什么？	最疯狂的自杀方式是什么？	1
我不小心吃了两次降压药，我没事吧？	血压100/76可以吗？	0
你有什么超自然的经历吗？	你最好的超自然体验是什么？	0
在2G频谱诈骗中，销售了哪个2G频段（900/1800Mhz）？	“Vyapam”骗局到底是什么？为什么这么多人因此而死亡？	0
我是一名优等生，但没有任何动机或意愿去上学。有人能帮我解决这个问题吗？	我的未婚妻最近去世了，这让我心痛，我该如何应对呢？	0
哪种股票最适合在日常交易中买卖？	在悉尼，哪家公司最适合获得商业销售和采购建议？	0
我和我的女朋友私下里发生了性关系。她会怀孕吗？	为什么大多数化妆品都没有价格标签？	0
我们能用切伦科夫大气辐射（伽马射线或类似的辐射）用地面望远镜从这里拍摄行星表面的图像吗？	我们能用地面望远镜用宇宙射线或甚高频伽马射线绘制行星的表面（和次表面）吗？	1
什么是抒情恶作剧的好歌曲？	在达哈布的蓝洞潜水？	0
如何将MacBook中照片中的原始文件转换为JPEG格式？	如何将原始文件转换为JPEG格式？	0
教孩子游泳的最佳年龄是多少？	什么时候是教孩子游泳的好时机？	1
啤酒和百事可乐哪个对你的身体不健康？	哪一种对你的身体不健康？淡啤酒还是百事可乐？	1
我在哪里可以找到我的导师？	我在哪里可以找到一位心甘情愿的导师？	0
什么会导致放大器断开？	什么会导致放大器断开？你怎么修理它？	1
我如何在数学上取得好成绩？	我如何在数学方面取得好成绩（cbse 9分）？	1
为什么Facebook Messenger在WebSocket上使用长轮询？	Facebook messenger使用长轮询还是WebSocket？	1
第三次世界大战的可能性有多大？	有可能发生第三次世界大战吗？	1
由于市场上也有出售假JBL扬声器，有没有办法识别出真正的JBL扬声器？	我计划购买一个10k INR以下的便携式蓝牙扬声器。我对JBL翻转2、JBL充电和JBL脉冲感到困惑。有什么评论吗？	0
我在上大学之前学过一些MOOC，现在我觉得大学很可怕，我该怎么办？	东芝卫星C50-A547适合运行游戏吗？	0
印度斯坦古典音乐和康乃馨音乐有什么不同？	在印度斯坦古典音乐中，泰特和拉加斯有什么不同？	0
我们如何解决克什米尔问题？	为什么不采取任何措施来解决克什米尔问题？	0
你认为数学是艺术还是科学？	数学是艺术还是科学？	1
山达基是骗局吗？	山达基是胡说八道吗？	1
谁将赢得2016年总统选举？	谁将赢得2016年美国总统选举？为什么？	1
为什么Polyvore撤掉Pasha Sadri的首席执行官职位，并用产品负责人Jess Lee取代他？	我拥有一家价值4.5亿美元的跨国公司，我想让我的儿子成为未来的首席执行官。我应该给他什么建议？	0
理解狭义相对论最好的书是哪本？	自学狭义相对论和广义相对论的最佳书籍是什么。关于这些主题的初级和高级书籍有哪些？	0
比热和热容有何不同？	热容和比热相同吗？	1
星际旅行中的A计划和B计划是什么？	当伏地魔在第四本书中复活时，他对食死徒们说，他最忠诚的仆人正在霍格沃茨做他的工作。他指的是谁：西弗勒斯·斯内普还是小巴蒂·克劳奇，作为疯眼？	0
无聊的时候有什么有趣的事情可以做？	如果我很无聊，我该怎么办？	1
如果艾达提到的工资总额是16400美元，那么工资总额是多少？	IDA薪级表基本工资9760卢比无限制+3%增量意味着什么？基本工资的总工资是多少？	0
我应该选择哪一本书作为数学二年级的准备书，是《化学原理》还是《元素》？（只剩下一个月的董事会）？	生物复杂性能被计算到一个特定的数学值吗？它是不可约的吗？	0
电影评论：你对阿米尔·汗的《丹加尔》（2016年电影）有何评论？	你对Dangal（2016年电影）的真实评价是什么？	1
当一个男人摸他女朋友的屁股时，他脑子里想的是什么？	为什么一个男人会向他的妻子/女友举手？他在想什么？	0
根据我的症状，我如何判断自己是否患有尿路感染？	是什么引起尿路感染的灼热感？	0
我应该吃什么食物来增加体重？	我怎样才能以健康的方式增加体重？	0
Stripe或Square Up是否作为“代理”处理资金转账，或者它们是否也在美国的支付处理器许可下？	像Square这样的支付处理器需要许可证吗？	0
我怎样才能知道是否有人在Facebook上没有跟踪我？	如果有人不关注我，这会影响Facebook上的聊天顺序吗？	0
你最钦佩哪位印度政治家？为什么？	你最讨厌哪个印度政客？	0
某一事件肯定会发生的概率是多少？	事件发生的概率总是零，这是真的吗？	0
一个人怎么知道自己有社交焦虑症？	我怎么知道自己是否有社交焦虑症？	1
Jahangir的妻子Man Bai是怎么死的？	T.I.的女儿是怎么死的？什么时候发生的？	0
我需要一个生物学IA（个人调查）的主题，我绝望，所以我可以有一个主题，而不是提示？	高中生物研究中有哪些有趣的课题？	0
我是一名印度人，计划今年一月去美国攻读硕士（STEM课程）。如果特朗普获胜，这将如何影响我在美国的未来？	特朗普成为总统对在美国申请硕士学位的印度人有何影响？	1
Shimla Hill车站的哪家酒店对未婚夫妇来说是安全的，没有警察、酒店员工和道德警察的骚扰？	德拉敦山车站的哪家酒店对未婚夫妇来说是安全的，没有警察、酒店员工和道德警察的骚扰？	0
世界社会正在走向理性的爱情契约吗？	除了人类，最聪明的哺乳动物有哪些例子？	0
进化是真的吗？这是如何被证明的？	进化以什么不同的方式被证明是真实的？	1
谁是印地语电影中最差的演员？	宝莱坞：目前最差的宝莱坞电影是哪部？	0
从头开始学习数据结构和算法的最佳方法是什么？	我如何开始学习或加强我对数据结构和算法的知识？	0
日常生活中有哪些放热的例子？	日常生活中有哪些吸热和放热反应的例子？	0
美国宪法被认为是活的文件吗？若然，原因为何？	是什么让美国宪法成为活的文件？	1
我如何在Instagram上看到我关注的人？	我怎么知道为什么我被Instagram屏蔽了？	0
SAP ERP关键用户的职责是什么？	什么是合格的SAP ERP关键用户？	0
由于长度收缩和其他相对论效应，理论上是否有可能在一年内旅行一光年？	一颗垂死恒星的引力有多大才能使原子消失？	0
为了以100万美元的价格出售我的公司，我需要筹集多少收入？	富有的成长（前1%）有什么好处？	0
如何在线填写pan卡申请表？	如何申请PAN卡？	0
是什么让你相信“一切都是有原因的”？	你相信一切都是有原因的吗？	1
GTA5和看门狗哪个更好？	在《看门狗2》的电子游戏中，你能对警察进行APB吗？	0
生活中最好学的东西是什么？	我们从生活中学到的最好的东西是什么？	1
什么是碘量滴定？它与碘量滴定有何不同？	为什么用移液管滴定？	0
反社会者会有很多心理变态的特征吗？	你能成为一个具有更多心理变态特征的反社会者吗？	1
Quora如何吸引初始用户？	Quora是什么时候开始的，它是如何吸引用户的？	1
如果乔恩长得像雷加，奈德会怎么做？	如果乔恩·斯诺继承了坦格利安人的“长相不是斯塔克人”呢？奈德将被迫承认他在撒谎说乔恩是他的私生子；这将如何改变整个故事的情节？	0
我搜索肯定在Snapchat上的人，但当我添加他们时，我会收到一条消息，说找不到他们。为什么？	在Snapchat上，有人阻止了我，但仍显示在“添加的我”部分，但Snapchat仍不允许我添加它们。发生什么事了？	0
未来的购物中心是什么？	购物中心将来会是什么样子？	1
拿破仑想要实现什么；他的目标是什么？	波斯帝国最大的成就是什么？	0
如何从我阻止的号码中检索文本？	如何在短信中屏蔽我的电话号码？	0
在悉尼哪里可以买到非常合理的男鞋价格？	在悉尼，哪里可以买到时尚定制的男鞋？	0
如果我在个人Instagram上发表评论，我的追随者会看到吗？	如果我跟随一个通知链接到我的评论，我现在如何看到我评论的答案？	0
房地产注册会计师运动？	一个印度人必须具备哪些素质才能进入美国大学攻读PG？	0
Quora上有哪些好的博客？	关于Quora的文章有哪些最好的博客？	0
我怎么能像杰克·威廉姆斯那样？	杰克·威廉姆斯如何看待杰克·威廉姆斯？	0
为什么FiveThirtyEight不开源他们的选举预测模型？	我遇到的每个人都不喜欢唐纳德·特朗普。那为什么人们还预测他会赢得美国大选呢？	0
斯里兰卡的贸易机会？	我应该怎么做才能在金融领域找到工作？	0
WhatsApp在服务器中保留传送的数据（如图像等）多长时间？	如何在WhatsApp中共享GIF图像而不将GIF转换为视频？	0
互联网公司营销部门的最佳结构是什么？	印度数字营销公司在新加坡运营的最佳结构是什么？	0
神经科学家是做什么的？一个神经科学的毕业生能在国外找到什么样的工作？神经科学的一些分支领域是什么？	有可能以316的GRE成绩进入神经科学研究生课程吗？	0
印度女孩用假阳具吗？什么样的假阴茎？	最大的假阴茎有多大？	0
布鲁斯·斯普林斯汀最理想的套路是什么？假设它有20首歌曲，包括安可。	布鲁斯·斯普林斯汀（音乐家）：谁是费城的胆小鬼？	0
印度医生的平均工资是多少？	在印度，医生的薪水是多少？	1
我23岁，女性。我的上半身比较重，但我的腿和臀部都很瘦。我的体形是什么？上半身的运动是什么？	为什么我能在训练上身和前臂后做手指俯卧撑？	0
我在哪里可以得到免费的书籍阅读或下载？	我在哪里可以买到免费的书？	1
哪个国家最容易找到国际学生的工作？	nift咨询的最大轮数是多少？	0
如果我侵入美国国家安全局和五角大楼，并把他们所有的文件都扔掉，（1）对我的搜捕会有多大；（2） 它最终会不会打开公众的眼睛，以及；（3） 黑客圈会怎么看我？	我们在服务器中将数据作为平面文件进行维护。黑客用什么方法打开平面文件？	0
温度为-10的最佳冬季夹克是什么？在哥印拜陀哪里可以买到？	有冬天的夹克可以在夏天穿吗？	0
谁是更好的击球手，维拉特·科利还是乔·鲁特？	在维拉特·科利和乔·罗特这两位球员中，谁是更好的球员？	0
一个普通人能做多少次引体向上？	一个人平均每天用手机拍多少张照片。？	0
特朗普赢得选举了吗？	你如何看待特朗普赢得选举？	0
人们在Facebook上炫耀吗？若有，原因为何？	与“炫耀”的人打交道的最佳方式是什么？	0
怀孕期间做爱安全吗？	有些女人在做爱时真的会喷射吗？服用阴道液体安全吗？	0
你是如何学习java的？	如何学习Java内部构件？	0
精子数量低的症状是什么？	精子数量低的原因是什么？	0
是什么让印度与世界其他地方不同？	是什么使印度不同于世界上所有其他国家？	1
“时代错误”这个词在句子中是如何使用的？	在一个句子中“难以表达”这个词是如何使用的？	0
作为一名新生，你如何免费推广应用程序？	你如何免费推广你的应用程序？	1
你对水晶有什么评价吗？	你对水晶法有何评论？	0
绿色和蓝色的混合是什么颜色？	如何使用其他颜色使颜色变成浅绿色？	0
我应该投票给唐纳德·特朗普还是希拉里·克林顿？	为什么我不应该投票给希拉里·克林顿或唐纳德·特朗普？	0
女孩喜欢口交吗？	为什么有些人喜欢做口交？	0
迪拜警察为什么开快车？	迪拜警方为什么有超级跑车？	1
你怎么知道你的豚鼠是否怀孕了？	你如何照顾豚鼠？	0
eps文件的用途是什么？	作为一名未来的ECE或机械工程师，我知道我必须学习HL数学和物理，但我的第三门HL课程应该是化学、CS还是经济学？	0
你如何一步一步地画一个天使？	你如何一步一步地画一只猫？	0
干细胞和分化细胞有什么区别？	“多能干细胞”、“多能干细胞”和“全能干细胞”之间有什么区别？	0
一个网站上的多个域对seo有害吗？	搜索引擎优化的更好选择是什么。使用分布在多个域上的多个网站，还是使用单个域？	0
我的CRS分数是469。我获得加拿大公共关系的机会有多大？	我计划申请加拿大公关。我的机会是什么？	0
微型自动取款机是如何工作的？是哪家银行在印度推出的？	在目前的印度，从自动取款机取款的最佳时间是什么时候？	0
历史上哪些个人和事件是圣多美和普林西比引以为豪的原因？	历史上哪些个人和事件是白俄罗斯的骄傲？	0
今天有没有不恨阿尔巴尼亚人的塞尔维亚人？	为什么塞尔维亚人喜欢俄罗斯人？	0
你醒着的时候能做梦吗？	人们醒着的时候能做梦吗？	1
这个问题的解决办法是什么？	以下问题的解决方案是什么？	0
林登伍德大学在就业前景方面最强的专业是什么，最弱的专业是什么？	就就业前景而言，东方大学哪些专业最强，哪些专业最弱？	0
我可以整天冥想吗？这有助于提高我的动力吗？	冥想真的有助于控制思想吗？我怎么能自己做呢？	1
生活怎么样？	你的生活怎么样？	0
Quora：你如何在Quora上发布问题？	问Quora问题的最佳方式是什么？	1
学习另一种语言有什么好处？	学习第三语言的好处是什么？	1
什么是双糖？什么是双糖的例子？	有哪些双糖的例子？	1
倭玛亚哈里发王朝为什么垮台？有什么办法可以避免他摔倒呢？	伊斯兰历史：倭玛亚哈里发为何入侵基督教领土？	0
“这个世界上每个人都是独一无二的”，找到自己独特性的最好方法是什么？	我如何防止这个世界上的其他人使用和我相似的名字？是否有任何方法可以保护我的唯一名称作为我的IP资产？	0
就就业前景而言，杰克逊州立大学哪些专业最强，哪些专业最弱？	就就业前景而言，莫尔黑德州最强的专业是什么？最弱的专业是什么？	0
我如何破解WhatsApp帐户？	我如何破解另一个WhatsApp帐户？	1
什么是新生最好的IT领域？	什么是最好的IT领域来获得新生？	1
哪里有安全的地方可以和女朋友做爱？	在印度，在车里做爱合法吗？	0
你有过惊人的巧合吗？	发生在你身上最大的巧合是什么？	0
谷歌为什么不收购Quora？	谷歌会收购Quora吗？	1
如何使用遮盖-揭开测试确定潜在斜视的一侧？	哪一个伤口愈合得更快，是覆盖的还是未覆盖的？	0
实验室/猎犬的混血儿会掉很多毛吗？如果是，如何处理？	爱斯基摩犬/可卡犬混种会脱毛吗？如果是这样，最好的治疗方法是什么？	0
如果性别是社会建构的，我们如何解释变性人？	如果社会颠倒了性别角色，变性人是同一个人还是不同的人？	1
耶稣喜欢香蕉吗？	为什么耶稣叫耶稣？	0
美国在秘密战争中向老挝投下的炸弹是否比第二次世界大战期间向欧洲投下的炸弹总数还要多？	除了日本无条件投降但不投原子弹来结束第二次世界大战，还有什么现实的选择？	0
如何在Roku上获得Internet浏览器？	如何使用Roku浏览互联网？	0
Excel中的下标和上标的快捷键是什么？	如何在Excel中选择单元格中的所有文本？什么是键盘快捷键？	0
孩子说的最奇怪或最令人不安的事情是什么？	你的配偶做过的最令人毛骨悚然的事情是什么？	0
我们如何改进高中和大学的教育体系？	你如何改善高中教育？	1
如何创建强密码？	如何创建强密码？有什么建议吗？	1
外星人真的存在吗？如果有，我们有证据吗？	外星人真的存在吗？如果是，那么在哪里？	1
如何找到黑客？	如何成为黑客？	0
阿兹特克人是谁？	阿兹特克的神是谁？	0
我们为什么要学习？	为什么我们需要学习？	1
智齿拔除后的恢复时间有多长？	为什么拔掉智齿后用盐水冲洗很重要？	0
希拉里·克林顿作为国务卿的积极成就是什么？	希拉里·克林顿作为国务卿的最大成就是什么？	1
增长和发展之间的区别是什么？	增长和发展的对比如何？	0
如何提高我的英语语言技能？我基本上来自古吉拉特邦。	如何提高我的词汇量和英语口语能力？我是一名22岁的软件工程师，来自泰卢固中等背景。我能写得很好，但我的口语能力很差。	1
我怎样才能有机会见到纳伦德拉·莫迪先生？	我怎样才能见到莫迪？	1
一个拥有小政府的繁荣社会（过去或现在）的例子是什么？	有没有一个国家是在自由主义的基础上运行的？	0
变性人有什么样的生殖器官？	你如何看待变性人？	0
以中国为母语的人学习英语的最好方法是什么？	作为一名中国学生，我怎样才能学好英语？	1
为什么人们相信上帝？	为什么人们相信上帝？对上帝的真正信仰是什么？你怎么相信上帝？	1
采用两个文件名作为输入并根据给定的联接字段联接两个文件中的行的Java程序？	如何使用Java中的FileWriter打印文件中的新行？	0
有史以来第一部音乐录影带是什么？	粉丝制作的音乐视频曾经作为歌曲的官方音乐视频发布过吗？	0
如果你发现了一款带有图案锁的metro PC手机怎么办？	我可以让我的Sprint手机为Metro PC工作吗？	0
在哪里可以买到电影的英文音轨？	有可能找到电影的“英文音频文件”吗？如果可能的话，我们可以在哪个网站上获得它们？	0
作为研究生就读滑铁卢大学是什么感觉？	滑铁卢大学的大一新生是什么样的？	0
我今年23岁，身高5英尺，体重60公斤，脂肪主要集中在腹部、大腿和臀部。我应该怎样做，做什么练习？	如何快速减掉或减少大腿和臀部脂肪？	0
你如何比较和对比酸和碱的性质？	你如何比较和对比碱和酸？	1
毕业于土木工程专业，在IT部门担任支持分析员2.5年，MIS结合了管理，是硕士的正确选择吗？	我是一名土木工程专业的毕业生，拥有两年的IT支持分析师经验。我不确定是攻读工程管理硕士（MEM）还是信息系统硕士（MIS）。在我做出选择之前，我应该考虑哪些因素？	0
2016年搜索引擎优化的最佳方式是什么？	2016年我如何做SEO？	1
什么定义了你的幸福？	幸福的定义是什么？	1
尼安德特人男性会如何看待现代女性？	我是女性尼安德特人男性会怎么看我？	1
每天步行3公里，持续60天会导致体重减轻多少？	我如何减肥和增加肌肉？	0
最快的赚钱方式是什么？	什么是快速赚钱的方法？	1
你如何编辑你的Quora档案？	如何编辑我的个人资料？	1
艾萨克·阿西莫夫写的十篇最好的短篇小说是什么？	你最喜欢艾萨克·阿西莫夫的故事是什么？	1
女人喜欢戴鸡圈的男人吗？	女人喜欢看男人射精吗？	0
我怎样才能创建自己的Minecraft Youtube频道？	启动YouTube频道时，我应该做些什么才能脱颖而出？	0
当你在公共场所开车时，其他汽车会嘲笑你吗？	我们为什么要在开车时关掉车内的灯？	0
哪一个是适用于阿平县的住院药物和酒精康复中心？	在赫德县，哪一个是合适的住院药物和酒精康复中心？	0
马六甲/马六甲哪里有鱼类温泉？	吉隆坡最便宜的购物地点是哪里？	0
如何减轻严重的慢性疼痛？	什么对你起到了帮助缓解慢性疼痛的作用？	1
我能做些什么来提高我的英语口语？	我怎样才能提高我的英语口语？	1
哪些是最好的历史播客？	历史上最好的播客是什么？	1
印度的穆斯林，特别是古吉拉特邦的穆斯林，憎恨（仍然）纳伦德拉·莫迪吗？	为什么一些印度穆斯林憎恨纳伦德拉·莫迪？	1
与律师做亲密朋友有什么好处？	与教授成为亲密朋友有什么好处？	0
我是个大块头。当我生气时，人们会害怕并指责我威胁他们。我该怎么阻止这一切？我其实不是一个暴力的人。	我生气的时候会阻止别人。我拒绝与他们交谈。为什么我会为这些小事生气？	0
谁真的陷害了兔子罗杰？	谁陷害兔子罗杰的主题是什么？	0
你遇到过外星人吗？请说实话，不要编造故事。	你遇到外星人了吗？怎么搞的？	1
当我在飞行时，我最不应该做的五件事是什么？	当我在飞机上时，我最不应该做的五件事是什么？	1
宝莱坞：超级印度电影中最糟糕的对白是什么？	宝莱坞最糟糕的电影是什么？	0
这是真实的生活还是幻想？	女王（乐队）：这是真实的生活，还是只是幻想？	1
2016年凯旋银行推出的最有趣的产品和创新是什么？	2016年，M&T银行推出的最有趣的产品和创新是什么？	0
在瑞典或丹麦等欧洲国家，印度工程师凭工作签证很容易找到工作吗？	在瑞典找到兼职工作容易吗？	0
现实的（真实）本质是什么？	没有人能否认的终极真理是什么？	0
民族主义是什么时候出现的？它对当今世界的影响有多大？	你是否曾经觉得你的未来对你来说没有刺激/幸福，事情总是平庸的？	0
在印度，什么地方最适合度假？	在印度，哪些地方是度假的最佳地点？	0
开始生产草药饮食产品需要什么许可证？	扩展板的制造和生产需要遵循哪些规范？在哪里可以找到扩展板的书面副本？	0
如果我在第11次标准CBSE考试中得分为65%，那么我的平均成绩是多少？	为什么波斯语单词“ذليل”在Microsoft Translator上的意思是“穆斯林”翻译错误？是故意的还是粗心的？	0
你的使命是什么？	你的人生使命是什么？	0
改进业务实践的最简单方法是什么？	我是一名国际学生，今年夏天我要去哈佛。我的F1签证被拒绝的可能性有多大？	0
我如何系统地学习Python？	从没有编程经验开始，学习Python 3需要多长时间？	1
我怎么知道有人喜欢你？	你怎么知道一个男人是否喜欢你？	1
你可以问面试官哪些好问题？	求职者应该问面试官什么问题？	0
我如何通过HP0-M40考试？	如何通过HP0-M33考试？	0
我有一台3d打印机。我怎样才能从中赚钱？	我如何用我的3d打印机赚钱？	1
开发像Zomato这样的应用程序需要多少钱？	开发像Zomato Order这样的应用程序需要多少成本？	1
为什么人们会在Quora上问一些简单的谷歌搜索就能找到的问题？	为什么人们发现在Quora上提出简单的问题比花几分钟在互联网上寻找直接的答案更容易？	1
哪些语言受到了低俗德语的深刻影响？	低度德语对哪些语言的影响最为深远？	1
平均堆栈在web编程中的应用是什么？	“你好”的含义和用法是什么？	0
在微软做一名应用支持工程师实习生值得吗？	2014年微软软件工程实习生的薪水是多少？	0
你是谁的榜样？	谁是你的榜样？	0
我告诉我的同学我的论文题目，她就那个题目写了她的论文。现在我们有非常相似的文章，我们都会被指控剽窃吗？	如果我让Quora上的人校对我的西班牙语文章并将校对稿提交给我的老师，这会被视为剽窃吗？	0
完成以下句子：我妈妈是？	最小的完整句子是什么？	0
印度在奥运会上失败的原因是什么？	为什么印度在里约奥运会上如此惨败？	1
海得拉巴的甜红酒店有哪些，在哪里？	什么是好的白葡萄酒甜度等级？	0
我到底要不要买这台新笔记本电脑？	我应该买一台新的笔记本电脑吗？	0
当你说宇宙正在“膨胀”时，它到底意味着什么？普朗克长度变大了吗？如何在对象之间有更多的空间？	如果宇宙在“膨胀”，我的房间在膨胀吗？原子在膨胀吗？一切都在扩大吗？	0
什么是triloca.com？	Kakigarden.com做什么？	0
孩子继承父亲和母亲的遗传特征的比例是多少？	你用什么名字保存你爸爸/妈妈的电话号码？	0
我如何计划去果阿的4天旅行？	我如何计划去果阿的三天三夜之旅？	1
在八核、1.7 GHz、Cortex A53、芯片组：联发科MT6752和四核、1.4 GHz、Cortex A53、芯片组：高通Snapdragon 410 MSM8916之间，哪个处理器更快、更适合电池？	哪种处理器更好：1.8 GHz英特尔四核还是1.7 GHz Snapdragon Octacor？	0
如何在端点安全防火墙中禁用检查点？	我有一个更新的付费防火墙/病毒扫描程序，我不使用未受保护的公共WiFi。我如何让自己更安全？	0
多尼放弃队长职务的决定对印度有好处吗？是不是他应该退休？	抛光玻化砖？	0
英国脱欧后，在英国的欧盟公民会发生什么？	如果英国在2016年全民公决后脱离欧盟，在英国的欧盟公民会怎么样？	1
为什么海拔升高时温度会下降？	为什么温度会随着海拔的升高而降低？	1
登山：有人能攀登珠穆朗玛峰吗？	我能在没有登山经验的情况下攀登珠穆朗玛峰吗？	0
在班加罗尔买笔记本电脑包的好地方是什么？	你能推荐一个在柏林买笔记本电脑包的地方吗？	0
费德维尔学院能教我制作现代PCB吗？	有没有人参加过费德维尔学院的PCB设计课程？	0
你听过的最好的笑话是什么？	你听过的最有趣的笑话是什么？	1
为什么Sachin Tendulkar拒绝参加Kapil Sharma秀？	当有人指出你的错误时，你感觉如何？	0
为什么没有关于伊斯兰教对印度的屠杀的描述？	为什么没有关于伊斯兰教对印度屠杀的描述。？	1
“你从未见过”的最佳足球进球是什么？	足球比赛中最好的进球是什么？	0
我怎样才能打动一个恨我的女孩？	怎样才能打动一个恨我的女孩？	1
与巴西大城市相比，牙买加大城市的生活是什么样的？	与墨西哥的大城市相比，生活在牙买加的大城市是什么感觉？	0
lasik激光手术后需要多长时间才能有清晰的视力？	有可能从低智商变成高智商吗？如果有，怎么可能？	0
加利福尼亚州南门附近哪家是合适的太阳能电池板安装供应商？	加利福尼亚州斯丁森海滩附近哪家太阳能电池板安装供应商比较好？	0
为什么黑人女性被认为不如亚洲或拉丁女性有吸引力，尽管她们在媒体上的代表性更大？	白人女性觉得亚洲男人有吸引力吗？	0
你怎么说1<x<2？	说1的最好方式是什么？	0
为什么人类会存在？	人类为什么会存在？	1
在日语中，“黑暗”怎么说？	日本人怎么说“哦，我的上帝”？	0
为什么特朗普支持者认为唐纳德·特朗普可以通过国会获得他的政纲？	为什么我不认识唐纳德·特朗普的支持者？	0
固体物质的一些常见例子是什么？	固体物质最常见的例子是什么？	1
我父母给了我“建议”，如果我不接受，他们会非常生气……我该怎么办？	给别人提建议的最好建议是什么？	0
您的家人是否在传统的美国感恩节大餐中加入了来自您祖国的特殊菜肴/食物？	感恩节是什么时候开始的？它是什么时候被定为美国的国定假日的？其他国家承认感恩节吗？	0
我应该如何激励自己每天去健身房？	我怎样才能保持每天去健身房的动力？	1
在线印刷店最好的免费wordpress主题是什么？	在这两位总统候选人的领导下，美国是否正在放弃其在向中国开放全球市场方面的战后领导地位？	0
在悉尼哪里可以买到地砖的超值货？	在悉尼地区，我在哪里可以以非常便宜的价格买到质量最好的墙砖和地砖？	1
为什么一些旧电脑游戏在功能强大的新电脑上运行得很快？	什么是一个关键的标准或计算机的一部分，使电脑快速的游戏？	0
如果我在不更改帐户的情况下更改国家/地区，如何继续使用优步？	我可以在其他国家使用我的优步推荐信用吗？如果我推荐其他国家的人怎么办？	0
对于BITSAT和IIT JEE MANES的“理论”而言，NCERT是否足够？	阅读NCERT教科书和解决模型问题论文是否足够做好准备，以便在BITSAT和JEE MANS中取得好成绩？	0
有了反穷人、反中产阶级的法律，比如商品及服务税、土地、劳工改革，印度会像中国一样变得独裁吗？	我们如何让印度国防部也像中国和美国一样关注网络战，我们有这么多具有良好黑客和反黑客/防火墙技能的人？	0
在短时间内学习编码的最佳方法是什么？	如何在短时间内轻松高效地学习编码？	1
一个完全陌生的人为你做过的最好的事情是什么？	陌生人为你做的最好的事是什么？	1
民主有哪些好的因素？	法西斯主义有什么好处，我们可以从适用于我们的自由民主国家中获益？	0
谁是生活中最好的老师？	谁是人生最好的老师？	1
为什么Huma Abedin没有立即允许FBI检查65万封电子邮件？	在一间只有一间卧室的公寓里长大是什么感觉？	0
如果我成为百万富翁，我应该告诉家人和朋友吗？	我应该告诉人们我已经成为百万富翁了吗？	1
Quora上有来自SJA Dehradun的学生吗？	“例外遗嘱检验规则”的更好翻译是“例外检验规则吗？”	0
九年级学生如何在线学习NTSE？有哪些好的作业网站？	如果目前在九班学习，我如何准备NTSE？	0
谁是最好的足球运动员？	今天谁是最好的足球运动员？	0
你看过的最恐怖的恐怖电影叫什么名字？哪一个是最恐怖的部分？	你看过的最恐怖或最恐怖的电影是什么？	1
如果一位主要政党提名人在大选前去世，程序会是什么？	如果总统候选人在11月大选前去世，会发生什么？	1
如果我经常通宵充电，我会弄坏我的智能手机吗？	智能手机充满电需要多长时间？	0
在没有API的情况下，Keyhole如何从Facebook获取哈希标签数据？	为什么散列标签如此重要？	0
谷歌眼镜看起来超级书呆子吗？如果是这样，谷歌如何克服这种看法？	谷歌能做些什么来扭转谷歌眼镜的局面？	0
在世界历史上的任何时候，印度和中国都是土耳其的一部分吗？	在不同的历史时期，谁是世界上最强大的国家？	0
在喀拉拉邦度蜜月的地方有哪些？	在印度喀拉拉邦，一个人在两天的旅行中可以游览哪些地方？	1
你经历过超自然活动吗？	你有没有经历过任何超自然活动？究竟发生了什么？	0
你会和你的配偶分享你最深的秘密吗？	你只有在Quora才能分享的秘密是什么？	0
你对印度政府禁止发行500卢比和1000卢比纸币有何看法？利与弊？	你对印度政府废除500卢比和1000卢比纸币有何看法？	1
“评估”和“评估”有什么区别？	评估和评价之间有什么区别？	1
哪些歌曲让你感到快乐？	有什么歌能让你开心？	1
你对《没有这样的事》（2001年的电影）有何评论？	你对《老友记》（2001年电影）有何评论？	0
你能买一块没有表带的苹果手表吗？	既然我有昂贵的苹果手表表带，包括链环手镯和经典扣，现有的苹果手表表带会与苹果手表3（2017）配合使用吗？	0
摇滚乐的最后十年是什么？	你会选择谁作为过去十年（2005-2015）中最好的摇滚乐队？	0
什么国家是社会主义国家？	还有社会主义国家吗？	1
针对Windows的Microsoft Office 2013和2016的主要区别是什么？	MS-Office 2007和2013的主要区别是什么？	0
我想在喀拉拉邦开一家电子杂货店。那么，印度现有的任何一家电子杂货店会允许我参观和研究他们的办公室吗？	如果你需要在一年内赚100万美元，你会怎么做？	0
如何描述加拿大地盾的地貌？	加拿大地盾的地形是什么？	0
英国脱欧真的会发生吗？	英国脱欧有可能发生吗？	1
我们如何破解Wifi密码？	我如何破解wifi？	1
葡萄牙是如何独立于西班牙的？葡萄牙和西班牙历史中的文化叙事是什么？	葡萄牙是如何从西班牙独立出来的？	1
谁可能会在巴基斯坦和伊朗之间的战争中获胜？	现在谁会赢得伊朗和巴基斯坦之间的“常规”战争？	1
电流在导体中流动时为什么会产生磁场？	为什么电流流过导体时会产生磁场？	1
在C语言中，如何为结构和数组分配内存？	C中是否允许动态分配数组？	1
我如何通过替换对[math]v^3（a^2-v^2）^{\frac{1}{2}}[/math]进行积分？	如何集成[math]\frac{x^2}{x^2-1}[/math]？	0
智齿长出来的最晚年龄是多少？	我的智齿很痛，但它长得很好，我在那里用牙线剔牙。那为什么会痛呢？	0
对于无法升级访问级别以查看SBI网上银行的完整交易，是否有任何解决方案？	在SBI online中将访问级别升级为完全交易权限需要多长时间？	0
烘焙：我如何制作松软且耐嚼的饼干？	没有面粉怎么烤饼干？	0
我应该在Omegle上增加什么兴趣来吸引更多的女孩？	Omegle在女孩中不那么有名。女孩们知道或喜欢Omegle吗？	0
我怎样才能停止过度思考我的关系中的每件事？	在我的关系中，我如何停止过度思考？	1
“故事的语言”是什么意思？	什么是c语言？	0
我申请经济学研究生院无研究/实习的策略是什么？	保持骨骼健康和强壮的一些重要因素是什么？	0
我呕吐时为什么不减肥？	减肥的最好方法是什么？	0
我如何在印度在线赚钱？	网上赚钱最简单的方法是什么？	0
保留一张500卢比或1000卢比的旧纸币作为记忆是犯罪吗？	旧的500卢比和1000卢比纸币的防伪特征是什么？	0
什么是自杀的常用方法？	有没有无痛自杀的方法？	1
摩羯座为什么要离开？	爱情对摩羯座意味着什么？	0
德语中的“das”、“der”、“die”和“den”有什么区别？	德语：“dem”和“den”有什么区别？	0
我是36岁的离异女性。我似乎无法实现结婚成家的梦想。有办法吗？	库拉，我能在4年内有300万美元来实现我的梦想吗？	0
在黄金海岸哪里可以买到美味的纸杯蛋糕？	在黄金海岸哪里可以买到质量上乘的纸杯蛋糕和各种口味的蛋糕？	1
为什么神奇女孩动画在韩国流行？	为什么以仙女为主题的魔法女孩在动画中很少见？	0
马克·斯鲁尔十几岁时是什么样子的？	马克·斯鲁尔是什么样的人？	0
时间旅行可能吗？如果有的话？怎样	时间旅行在理论上仍然是可能的吗？	1
为什么Hansie Cronje是南非史上最伟大的队长？	南非白人是什么样的？	0
您能否在多个移动设备上使用一个Spotify premium帐户？	如果我的iPhone上有Spotify premium帐户，我的朋友可以在他的iPhone上使用它吗？	0
引用的版权法是什么？我可以把一个报价，做成海报，在Etsy上卖吗？	为什么微软不对数以百万计的盗版Windows采取行动？	0
我计划加入美国CTS（认知），听到这些传言，即使他们承诺，他们也不会为他们的员工申请绿卡。这背后的事实是什么？	我是英国公民，烫发。扎扎公寓。考虑到“英国本地人没有资格申请”，我可以申请绿卡彩票吗？	0
有没有其他人的皮肤看起来很干净，但如果你挤压毛孔，就会有很多白色黏液“蠕虫”出来？	为什么我的脸出汗，鼻子上的毛孔里冒出臭味？	0
在互联网上使用真实姓名有多安全？	在网上有你的真实姓名有多安全？	0
我拥有一个个人网站/博客。如果我获得了不错的流量，我想通过广告赚几块钱。法律允许我在H1B签证上这样做吗？	我姐夫打算在纽约开一家店。他可以申请我作为他的商店的工人来获得H1b签证吗？	0
用哪本书为neet做化学准备？	哪本化学目标书适合NEET 2017？	1
当我每天有200封电子邮件时，如何在outlook中管理收件箱以实现快速响应？	当涉及到大规模电子邮件营销时，你认为a.com比a.net.us有更好的收件箱机会吗。信息等。？	0
在课文中有什么好的真理或大胆的问题可以问？	聊天时最好问女孩什么问题？	0
晶闸管双脉冲的目的是什么？	人生的目的是什么？	0
在禁止发行500和1000卢比纸币后，印度的房地产价格将受到怎样的影响？	500和1000的非流通纸币对房地产有何影响？	1
软煮一个鸡蛋需要多少分钟？	生鸡蛋和煮鸡蛋哪个更好？	0
如果我最好的朋友吸毒，我该怎么办？	戒毒所是什么样的？	0
从菲尼克斯到洛杉矶的USPS头等舱需要多长时间？	向香港运送美国邮政需要多长时间？	0
我是生物系的学生，我是怎么被生物技术学院录取的，而我12年没学数学？	请告诉我vits Vellore生物技术学院录取的整个过程。我是12年级的生物系学生。我在那里没有数学课？	1
毕业于顶尖大学的机械工程师们的生活是怎样的，他们没有选择校园内的工作场所？	为什么许多顶尖学院（如印度理工学院/国立理工学院）的工科毕业生在毕业后立即攻读MBA？	0
我在网上赚钱的选择是什么？	网上赚钱的最好方法是什么？	1
是什么书改变了你？	改变你的那本书是什么？	1
买一台新笔记本电脑需要考虑什么？	买一台新笔记本电脑时要考虑什么？	1
对于一对夫妇来说，在20万卢比的预算内，哪一个是12月蜜月的最佳目的地？	对于一对夫妇来说，在40万卢比的预算内，哪一个是12月蜜月的最佳目的地？	0
如果一个前男友和我分手了，他为什么会在社交网络上跟踪我？	自从2012年分手后，我们就没怎么说话了，为什么我的前任会在搞笑节目上跟着我？	0
我该如何停止咬指甲？	我怎么才能永远不咬指甲呢？	1
我如何避免在巴黎看起来像个游客？	我在巴黎怎么穿才能避免看起来像个游客？	1
目前（2015年）印度宪法中有多少条款、部分和附表？	印度宪法有多少页？	0
网上赚钱的好方法是什么？	我怎样才能用很少的投资在网上赚钱？	0
特朗普是普京的满洲总统吗？	当选总统唐纳德·特朗普是普京总统的特洛伊木马吗？	0
12日后完成IIT JEE有什么好处？	你对斯蒂芬·马格林的书《沉闷的科学：经济学家的思维如何破坏社会》有何看法？	0
我如何计划一个新娘淋浴派对？	我怎样才能在另一个州计划一个新娘送礼会？	1
为什么印度的教育体系如此糟糕？	印度工程教育体系出了什么问题？	1
最好的接送线路是什么？	我怎样才能找到一个比我高的女孩？	0
为什么普杜切里和德里的联邦领土有自己的议会？	为什么只有德里和普杜切里的联邦领土有首席部长而没有其他部长？	1
黑天鹅电影背后的故事是什么？	天鹅湖黑天鹅背后的故事是什么？	1
有什么工作可以让我把创意和科技结合起来吗？	有没有什么体面的工作可以让我坐下来看书，并获得高薪？	0
如何在我的Xbox one上获得GTA v的mods？	我可以在Xbox 360 E中玩GTA 5吗？	0
第三次世界大战即将来临吗？	第三次世界大战是否比预期的更为迫在眉睫？	1
使用Quora的最大优势是什么？	对Quora有什么好处？	1
如果乔恩成为国王，瑟曦会怎么做？	如果乔恩成为国王，梅丽珊卓会怎么做？	0
罗尔斯·罗伊斯汽车有什么特别之处，它们只被授予受人尊敬的人物？	罗尔斯·罗伊斯（Rolls-Royce）汽车是否只提供给知名人士？	1
为什么脊柱在灵性上被视为宇宙的轴心？你是如何掌握脊柱的？	你怎么能治疗脊椎中部的疼痛呢？	0
叶绿体和线粒体有什么相似之处和不同之处？	当添加氰化物时，动物细胞线粒体中的电子与植物细胞线粒体中的电子有什么区别？	0
我在哪里可以买到Ranbir Kapoor在歌曲《Matargashti》中穿的夹克？	在叶加瓦尼·海迪瓦尼的《伊拉希之歌》中，兰比尔·卡普尔的胡须风格是什么？	0
一个人在喝了鼠药后需要多长时间才能死去？	一个人如何检测他们的杂草是否掺有鼠药？	0
为什么伊斯兰教允许并鼓励表亲结婚？这是否仍在实践中？	在伊斯兰教中，堂兄弟姐妹经常结婚吗？	0
我如何知道我的WhatsApp帐户是否被黑客入侵？	如何通过我的手机破解任何人的WhatsApp帐户？	0
你对印度政府取消500卢比和1000卢比纸币的决定有何看法？	印度政府将500和1000卢比纸币非法化的决定是一个绝妙之举还是一个有缺陷的计划？	0
有没有低智商的名人？	那些低智商的名人是谁？	1
有没有存档应用程序可以让你在图片中搜索文本？	气象学的研究可以（部分）用于了解癌症的发展和运动模式吗？	0
喀拉拉邦有哪些好的旅游景点？	喀拉拉邦有哪些好海滩可以参观？	1
唐纳德·特朗普能兑现他的竞选承诺吗？	唐纳德·特朗普能兑现什么承诺？	1
为什么媒体不报道/谈论特朗普涉嫌强奸一名13岁女孩的审判？	为什么主流媒体或希拉里不谈论特朗普12月强奸13岁少女的审判？	1
为什么洛克决定在克拉斯特的城堡杀死布兰·斯塔克？	为什么洛克要在克拉斯特的监狱里杀害或绑架布兰·斯塔克？	0
如果你在纽约每年挣13万美元，你的双周带回家的钱是多少？	为什么100000格罗斯的实得工资在美国这么低。？	0
如何治疗痤疮疤痕？	如何治疗痤疮？	0
《火星人》（2015年电影）：马特·达蒙为什么不能用他第一次使用的粪便逻辑种植更多的土豆？	火星上的科学有多可信？	0
与伟大的图书管理员保持密切的关系是什么感觉？	当图书管理员感觉如何？	0
一个人如何写博客？	建立一个成功的博客最好的方法是什么？	0
黄油提取物的最佳替代品是什么？	黄油豆的好替代品是什么？	0
“上传”-“导入”和“导出”-“下载”有什么区别？	加州进口和出口什么？	0
HP OfficeJet 4620 Airprint与HP LaserJet Enterprise M506x相比如何？	HP OfficeJet 4620 Airprint与HP LaserJet Enterprise M606x相比如何？	1
我怎样才能在谷歌的首页上看到我公司的网站？	如何在Google[搜索特定关键字]的第一页上获取我的网站？	0
如果你的母亲在你还是个孩子的时候就离开了你，但你和你的父亲呆在一起，那么找到她最好的方法是什么？	“如果你不能照顾我的女儿，那你为什么要和她在一起？”这个问题的最佳答案是什么？请注意，这是一位挖苦人的母亲说的。	0
在印度，PHP开发人员的工作范围是什么？哪些跨国公司雇佣PHP开发人员？	在印度，哪些是PHP的跨国公司？	0
什么是最好的减肥方法？	减轻体重的最好方法是什么？	1
你是如何被注意到的？	我怎样才能在宝莱坞引起注意？	0
如何在一周内学习node.js？	学习Node.js的最佳方式是什么？	0
你一生中最好的决定是什么？	你一生中做出的最好的决定是什么？	1
我们应该相信我们的政治领导人吗？	我们应该考虑别人说的话还是只相信我们的头脑？	0
巴沙尔·阿萨德是精神病患者吗？	巴沙尔·阿萨德住在哪里？	0
我是葡萄牙人，我想搬到挪威。可能吗？	我22岁（工作），我想成为板球运动员，因为我喜欢板球。我还有可能加入板球学院并进入国家队吗？	0
在阿布扎比的大学里为外籍人士（马斯达尔、哈利法、石油学院）教书是什么感觉？	阿布扎比（或酋长）修建马斯达尔城的原因是什么？	0
当外国游客第一次被邀请到马提尼克岛某人的家时，他们应该带什么好礼物？	当外国游客第一次被邀请到巴基斯坦某人的家时，他们应该带什么好礼物？	0
印度是否应该从尼泊尔购买一些土地，以拓宽西里古里走廊，方便进入印度东北部？	印度政府能否与孟加拉国交换一些土地，以便将鸡脖子走廊扩大到100多公里？	0
C++中的常量对象是什么？	什么是C中的常数？	0
你如何测量猫的智商？	你怎么能免费测量你的智商？	0
出租车的固定价格是6美元，每英里0.75美元。如果你只有20美元可以花，你能走多少英里？	假设你以每小时4英里的稳定速度划独木舟。你向下游和上游走6英里。水流的速度是多少？	0
土耳其有什么样的政府？和威尔士的相比怎么样？	土耳其有什么样的政府？它与波兰的相比如何？	0
我知道但你不知道但我不应该知道的最有趣的事实是什么？	大多数人不知道的最有趣的事实是什么？	1
墨西哥南部边界有围墙吗？	像唐纳德·特朗普所说的那样在美国和墨西哥之间筑墙可行吗？	0
苏丹的食物和烹饪有什么不寻常或不同之处？	巴基斯坦的食物和烹饪有什么不寻常或不同之处？	0
在浦那我可以实习的核心电子公司有哪些？	哪些公司在浦那从事核心电子工作？	0
在越南投资的公司是什么？	我如何在越南获得企业投资？	0
第一次看到另一个种族的人是什么感觉？	我们有没有关于过去人们有生以来第一次看到另一个种族的人的第一手资料？他们的反应如何？	1
什么是喜马拉雅粉盐？为什么更好？	什么喜马拉雅盐最好，为什么？	0
哪一个南美国家的生活成本较低？	哪一个南美国家的旅游成本较低？	0
美国是否应该在总统选举中有一个“以上任何一项”的选择？	选民是否应该有“以上任何一项”的选择？	0
如果上帝创造了世界，谁创造了上帝？	谁创造了“上帝”？	1
我该怎么做才能变得公平？	我怎样才能变得更白？	1
不管花费多少，哪支派克钢笔在外观和书写方面都是最好的？	自来水笔是如何工作的？	0
在涡轮机中，为什么实际过程中（工作物质）的最终焓大于等熵过程的最终焓？	在涡轮机中，为什么实际过程的最终熵大于等熵过程的熵？	0
为什么阿纳布·戈斯瓦米从《泰晤士报》辞职了？	为什么阿纳布·戈斯瓦米现在辞去《泰晤士报》主编的职务？	1
开咖啡馆最好的理由是什么？	开办自己的咖啡馆需要什么条件？	1
在海得拉巴有什么事要做？	海得拉巴最酷的冒险活动是什么？	1
索尼Xperia Z5白边容易刮伤吗？	索尼Xperia Z5的前屏幕和后屏幕上是否有Gorilla Glass或Dragontrail？	0
增加词汇量的最佳应用是什么？	对于高级英语学习者来说，改善词汇和语法的最佳Android应用程序是什么？	0
将iTunes音乐下载到flashdrive是否违法？	我在iPad上下载的iTunes音乐在哪里？	0
谁发明了中指这个坏姿势？它是怎么发明的？	谁发明了中指这个坏姿势？	1
如何计算离子和离子网络方程？	如何得到HCO3+H2O的净离子方程式？	0
在印度给女朋友最好的礼物是什么？	送给女朋友最好的礼物是什么？	0
说“如果你需要帮助，请告诉我”或我必须用“是否”是正确的吗？	如果我想说，“让我知道你是否可以尝试某件事并完成它”，那么说“让我知道你是否可以尝试”是否正确？	0
有共和党人投票支持希拉里·克林顿吗？	还有其他共和党人投票给希拉里·克林顿吗？	1
了解哪些生理学技巧是有用的？	了解哪些心理学技巧是有用的？	1
在AKC向Maltipoo这样的狗注册的目的是什么？	如何在AKC注册Maltipoo？	1
你在公共场合最尴尬的时刻是什么？	你在陌生人面前最尴尬的时刻是什么？	1
你能用电脑做的最酷的事情是什么？	在电脑上你能做的最酷的事情是什么？	1
我们为什么不使用传送带来缩短机场跑道？如果这个想法是新的，这是否意味着它至少应该以我的名字命名，如果不是专利的话？	美国或俄罗斯选举一个疯狂到足以发动核战争的人（唐纳德·特朗普除外）的可能性有多大？	0
如果没有辅导，我如何准备入门？	在没有任何指导的情况下，你是如何准备入场的？	1
印度的特拉文科州在哪里？	印度宪法中的州是什么？	0
塔加洛语单词“salamat”在英语中是什么意思？	塔加洛格：萨拉马特·波在英语中是什么意思？	0
怎样去除头皮屑？	如何去除严重的头皮屑？	1
有谁能帮我把哈伦和拉希德的性格和故事《哈伦和故事之海》中的角色进行比较和对比？	我想在国外学习生物技术我必须做什么？	0
为什么Infosys拒绝了2014批中的大量候选人？	2016年1月9日之后的下一批Infosys是什么时候？	0
唐纳德·特朗普会是美国历史上最糟糕的总统吗？	唐纳德·特朗普会成为最糟糕的总统吗？	1
有没有人的RFID护照被黑客入侵，身份被窃取？	如何使用被盗护照？	0
Ticketfly为WillCall支付了多少钱？	微软为LiveLoop支付了多少钱？	0
好莱坞有史以来最好的十部电影是什么？	好莱坞最好的电影是什么？	1
如果猫抓伤了你的眼睛，你该怎么办？	如果我眼睛下面有猫抓，我该怎么办？	1
如果全世界只有一种宗教，我们会认为世界会和平吗？	如果全世界只信奉一种宗教，它会更和平吗？	1
我怎样才能快速摆脱蚊子叮咬？	如何去除蚊虫叮咬的痕迹？	1
泰温和谢睡觉纯粹是出于怨恨吗？	为什么泰温和谢睡在刀剑风暴中？	1
在一妻多夫关系中，作为第三个人或非第一个人是什么感觉？	在多妻制关系中当三轮车是什么感觉？	1
北约和中央情报局是土耳其失败政变的幕后黑手吗？土耳其为何清洗北约军事特使？	如果俄罗斯进攻，北约会保卫土耳其吗？	0
解决数独难题最有效的编程算法是什么？	什么是类似数独的谜题？	0
在加尔各答哪里可以修理我的MacBook主板？	在加尔各答哪里可以修理我的MacBook R.A.M？	0
你的人生观是什么？	关于生命的一些理论是什么？	0
日产Sentras是好车吗？为什么？	我的第一辆车应该是丰田花冠、本田思域还是日产Sentra？考虑2003-2007年的所有这些	0
healthprofs.com有哪些替代方案？	除了BetaFamily.com，还有哪些其他选择？	0
黑人和印度女孩约会的可能性有多大？	黑人喜欢和印度女孩约会吗？	1
什么是共同基金？	共同基金是什么？	1
现代触摸屏是如何工作的？	触摸屏可以在水下使用吗？	0
哪个国家的技术更先进；德国还是日本？	在日本，为了感受他们最新的技术进步，最好去哪些地方？	0
2016年哪部电影最好？	2016年最佳影片是哪部？	1
量子纠缠的证据是什么？	什么是量子纠缠？	0
我应该找一个新的钢琴老师来代替我现在的钢琴老师吗？	我发现一次做很多事情很容易，但我的父母和老师建议我一次做一件事。我的态度是对的还是应该改变？	0
齿轮箱的功能是什么？	与滑动啮合齿轮箱相比，恒定啮合齿轮箱的优点是什么？	0
我应该担心人们对我的看法吗？	我是否应该在意别人对我的看法？	1
Uber、Uber Black和Uber出租车之间有什么区别？	优步与纽约市的出租车相比如何？	0
如何使用windows 10刻录dvd电影？（回答前请阅读说明）	什么是高音宝莱坞音乐歌曲？	0
为什么Quora声称我的问题需要改进？	为什么Quora一直告诉我我的问题需要改进？	1
女孩们最喜欢什么评论？	我和女朋友解除婚约是对的吗？有关详细信息，请参见注释	0
B-树和B+树之间有什么区别？	B+树和B-树有什么区别？	1
按要素成本计算GDP的方程式是什么？	按要素成本计算GDP和按生产者价格计算GDP的意义是什么？	0
聚光灯网络从哪些大学招收新毕业生？他们在找什么专业？	极限网络从哪些大学招收新毕业生？他们在找什么专业？	0
在声誉方面，麦吉尔大学能与常春藤联盟相比吗？	资助常春藤盟校学位需要多少钱？	0
你所说的财务报表分析是什么意思？	财务报表分析的必要性是什么？	0
如何从iPhone4中取出电池？	如何从iPhone4上取下电池？	1
我的名字在证书上是inder，但现在我试着填写一份申请表，需要姓氏，我能做什么？	在纳粹占领期间，法国学校的孩子们教了什么？	0
今天20k以下最好的笔记本电脑是什么？快速和顺利。	在20k以下我能买到的最好的笔记本电脑是什么？	1
当你进行时间旅行时，你会改变整个宇宙的时间还是仅仅改变你所在的地点？	当你第一次坐飞机旅行时，你感觉如何？	0
人们需要瑞典威士忌摊。你不是因为他们而有麻烦吗？	我想转到它，但我不知道编程，也不想做编程。还有其他职业道路吗？	0
土耳其本土的野生动物是什么？	什么动物原产于土耳其？	1
我是否需要通知航空公司柜台，我在国际航班的托运行李中有一支复制的气手枪或步枪？	我和我的家人已经过期了我们没有使用的bi/b2签证。我们可以重新申请续期吗？	0
我们真的能破解Facebook吗？	我能破解Facebook吗？	1
你如何看待印度政府通过废除500卢比和1000卢比纸币来打击“黑钱”的决定？	印度政府的决定将受到什么样的影响₹500/₹1000张纸币？	1
如何在Gmail上检索废弃的草稿？	Gmail：如何检索Gmail草稿？	0
人们在Quora上花了多少时间？	Quora在你一天中占用了多少时间？	1
我的眼力是-2.5。我能符合6/9视力的标准吗？如果不能，我的视力到底适合什么？	视力（视力）：-4.5眼的数量非常大吗？这是什么意思？	0
勃起功能障碍如何治疗？	如何克服过度自慰导致的勃起功能障碍？	1
你小时候还能学习新的语言吗？	是否仍在创建新的语言？	0
你生命中最艰难的时期是什么时候？你是如何度过的？	你经历过的最艰难的时刻是什么？你是如何度过的？	1
世界上什么地方最适合游览？在印度什么地方最适合旅游？比哈尔邦最好的旅游地点是什么？	在印度什么地方最适合游览？	0
一对有5个儿子的夫妇去野餐了。每个儿子有7个姐妹。每个姐姐有三个孩子。总共有多少人去野餐？	为什么威尼斯有这么多“禁止野餐”的标志？	0
生物化学在农业中的重要性是什么？	为什么Aman Goel没有选择在美国顶尖大学攻读硕士学位，而是决定去工作？	0
谷歌会购买Twitter吗？	谷歌会收购Twitter吗？	1
使用“接受”这个词的句子有哪些例子？	使用“感知”这个词的句子有哪些例子？	0
IBPS PO的清算策略应该是什么？	如何准备IBPS PO的预备考试？	1
禁止发行500&1000卢比纸币如何解决黑钱问题？	500卢比和1000卢比纸币的非货币化是否有助于遏制印度的黑钱？	1
为什么特朗普支持者认为唐纳德·特朗普可以通过国会获得他的政纲？	你认为唐纳德·特朗普为什么会得到如此多的支持？	0
巴基斯坦是世界上最糟糕的民主国家吗？	什么是民主？巴基斯坦有什么样的民主？	0
如果宇宙在死后倒转，这是否意味着我可以重生？	灵魂离开身体后会发生什么？	0
在孟买，从投资者的角度来看，一辆奥拉迷你出租车平均每月能赚多少钱？	从投资者的角度来看，在班加罗尔，一辆奥拉迷你出租车平均每月能赚多少钱？	0
如果Quora上的问题被标记为需要进一步改进，该怎么办？	我怎样才能问Quora一个关于标记为“需要改进”的问题？	1
iCloud如何从应用程序进行备份？	如何从iCloud中删除应用程序？	0
如何删除忘记密码的旧Facebook帐户？	如果我忘记了我的电子邮件和Facebook密码，我该如何进入Instagram？	1
什么是运营质量？	运营质量如何？	1
有可能将iOS植入Android手机吗？	有可能在Android手机上安装iOS吗？	1
在印度投资较少的情况下，有哪些创造性和创新性的商业理念？	投资最少的最佳商业理念是什么？	1
交通警察站在路中间拦车是合法的吗？	交通警察站在路中间停车合法吗？	1
为什么欧洲社会忽视了在阿拉坎发生的屠杀和残忍？	[2015年末/2016年初]英国为何要退出欧盟？为什么那里的一些人想退出欧盟？	0
有史以来最聪明的嘻哈独角戏是什么？	有史以来最难的嘻哈/说唱歌曲是什么？	0
如果你从小偷那里偷东西，那是偷窃吗？	如果你是从小偷那里偷东西，那是偷东西吗？	1
什么是“准合同”？有哪些例子？	有效合同的要点有哪些例子？	0
学习SolidWorks或Catia哪个更有益？	SolidWorks、CATIA和Pro E等软件是否适用于不同的应用程序？哪一个是最好的？为什么？	0
我可以登记一辆没有通过检查的汽车吗？	我住在佤邦，想从另一个州买一辆肌肉车。这辆车有一个更大的马达，这意味着我不能在这里登记吗？	0
印度最好的组合厨房是什么？	班加罗尔最好的组合厨房是什么？	0
如果一个和我约会的女孩在两个月内两次叫我另一个名字，这是个坏兆头吗？	在我二十几岁的时候，每次我开始和一个女孩约会，她都会在1-2个月后消失，不再接听电话/短信。发生什么事？	0
我已经在下面发了我的简历。？	在公司里，我应该把简历寄给谁？	0
我怎么知道一个男孩是否爱我？	我怎么知道我的女朋友是否真的爱我？	0
什叶派和什叶派有什么区别？	伊斯梅尔教派与其他什叶派有什么不同？	0
茶：用塑料电热壶烧水危险吗？	为什么我们应该避免在塑料杯里放热茶？	0
我怎样才能做一个健康的自制比萨饼？	我怎样才能做健康的比萨饼？有什么食谱吗？	1
一个人应该读什么来学习哲学？	我可以读哪些书来了解更多哲学知识？	1
更换自行车上的刹车要花多少钱？	更换制动器和转子的平均成本是多少？	0
希拉里·克林顿将如何赢得伯尼·桑德斯的支持者？	2016年美国总统选举：如果伯尼·桑德斯赢得提名，希拉里·克林顿的支持者会支持他吗？	0
ICICI银行销售专员的职责是什么？	ICICI银行是工作的好地方吗？	0
如何使用jQuery设置和取消设置cookie，例如创建名为“someName”的cookie并将其值设置为“someValue”？	我为php创建了一个自定义错误处理程序，并将其设置为我的错误处理程序，但仍然会显示致命错误，如何停止它？	0
Zee新闻是印度人民党拥有的频道吗？	为什么ZEE新闻如此反AAP？	1
如何处理分手？	我如何处理我的第一次分手？	0
我是一个胸围38，臀部41的男人。我想缩小我的臀部。我该怎么做？	什么运动可以帮助减轻我手臂上的重量？	0
我怎样才能成为以英语为母语的人？	我如何像名人一样说英语？	1
你如何为一篇文章写一篇漂亮的引言？	我怎样写一篇文章的引言？	1
缅甸人对印度人有什么看法？	人们如何看待印度女性？	0
在亚马逊上买什么东西最好？	我能在亚马逊上花2欧元买到的最好的东西是什么？	0
汉堡包配什么配菜？	什么配菜配羊排好？	0
在悉尼，我在哪里可以获得购买房产的最佳帮助？	我在哪里可以获得有关悉尼财产转让的知识帮助？	1
你是否经历过任何超自然或超自然现象？	你是否经历过科学无法解释的超自然事件？	0
如何改善消化？	我们怎样才能改善消化？	1
如果我有一个永久性的固定器，我需要戴上可拆卸的吗？	使用永久性固位体使用牙线安全吗？	0
我怎样才能在国际图书馆发表关于牙科的论文？	我怎样才能在国际图书馆发表关于教育的论文？	0
关于国家的氰化物和幸福漫画是什么？	什么是最好的氰化物和幸福漫画？	1
如果204=8503=13305=11和907=25，那么705是多少？	为什么我不能在Python中乘法分数？	0
IP伪装克服了网络地址转换（NAT）的哪些缺点？	NAT代表什么？	0
如果冷空气比热空气密度大，那么为什么温度会随着海拔的升高而降低？	物理学：为什么被污染的空气比冷空气密度大？	0
淋巴结是如何形成的？	什么是淋巴结？	0
如何购买特斯拉的股票？	我如何购买股票？	0
就人口而言，我们是世界第二大国，但我们在奥运会上只赢得了很少的奖牌。为什么？	如果印度是人口第二大的国家，为什么不像中国或美国那样拥有奥运奖牌？	1
你最喜欢吃什么？	你最喜欢吃什么？为什么？	1
我在哪里可以找到我可能购买股票的公司名单？	我想和你联系，我怎么做？	0
多米诺菜单上最受欢迎的比萨是什么？	多米诺骨牌比萨有多少卡路里？	0
魔法中的九次方是什么？	魔法中的力量9卡是什么：聚会？	0
有什么好书是专为吉普赛人准备的？	什么是最好的书籍，以实践吉普赛人只？	1
为什么世界七大奇迹被称为奇迹？	世界七大奇迹是什么？	0
我什么时候开始准备ILT？	如果这本书花费250美元，人们如何在《精神疾病诊断与统计手册》（DSM）中查找？	0
你怎么知道有人在对你施黑魔法？	你怎么能通过看一个人知道他在施黑魔法？	0
《双匕首》的歌词是什么？	你最喜欢的十大“太阳”歌曲是什么？	0
两天后，我应该如何准备Mu Sigma？	为Mu西格玛做准备的最佳方法是什么？	0
MITID是一个很好的电影制作机构吗？	Edupristine是SAP学习的好机构吗？	0
停止毒品战争是失败主义者吗？	我们能做些什么来阻止毒品战争？	0
在“有趣/尴尬”的照片网站上找到你、朋友或家人的照片是什么感觉？	什么样的图片或照片，当你看到它时会让你思考很多？	0
使用Firebase作为移动应用程序后端的缺点是什么？	为移动web应用程序、Stamplay或Firebase创建后端哪个更好？	0
神奇宝贝“发烧”会持续多久？	你认为这种神奇宝贝的流行趋势会持续多久？	1
我如何使用我的epf帐户？否我有uan？	如果我忘记了密码并且无法访问与我的Quora帐户关联的电子邮件，我如何重置密码？	0
如果我见到Richard Muller博士，我该怎么称呼他？我是用德语发音加乌姆劳特还是简单的英语发音？	我男朋友叫我性感是什么意思？	0
汉明码综合症是如何解释的？	“输入密码”到底是什么意思？	0
有史以来最听错的歌词是什么？	你最喜欢听错的歌词是什么？	1
纳什维尔有哪些汽车服务？与出租车相比，它们有多好，彼此之间有多好？	费城有哪些汽车服务？与出租车相比，它们有多好，彼此之间有多好？	0
将产品从印度运送到美国有哪些便宜的选择？	如何在150美元内将100公斤的行李（衣服）从美国运送到印度？	0
我们离第三次世界大战有多近，情况会有多糟？	第三次世界大战离我们有多近？	1
TCS是否会在培训期内终止？	TCS培训期如何？	0
如何提高我的写作技巧和博客风格？	我怎样才能提高写书的写作技巧？	1
可持续发展的概念是什么？	什么是可持续发展？	1
急救人员和护理人员：如何治疗枪伤？	如何治疗枪伤？	1
linustechtips的Linus Sebastian使用什么样的电话？	我最近用手机太多了。我觉得我因为太多使用手机而得了多动症。我该怎么办？	0
唐纳德·特朗普是如何成为总统的？	唐纳德·特朗普如何在预测他将失败的情况下获胜？	1
太阳在哪里发生核反应？为什么会这样？	是什么引起太阳中的核反应？	1
本田爵士乐和大众马球哪个更好？	Hondas或Accuras是更好的汽车吗？为什么？	0
痤疮疤痕最有效的治疗方法是什么？	痤疮有没有有效的治疗方法？	0
新加坡明星的职业生涯真的值得吗？	我是英国的一名计算机科学专业的学生——值得去新加坡参加2012年的Echelon吗？	0
我送了一份礼物给一位潜在的导师，并在4天后跟进。还是没有反应，我应该去参加他的下一个活动吗？你会怎么做？泰：）	为什么模拟计算机比数字计算机快？	0
你醒来后做的第一件事是什么？	当你醒来时，你在想什么？	1
布什总统任期（2001-09）：为什么唐纳德·拉姆斯菲尔德在2006年被解雇？	在你诚挚和尊重的意见中，乔治·W·布什总统应该如何重新融入社会（社区、国家、世界）？	0
我应该剃光头吗？	剃头后我该怎么办？	0
我们怎么会忘记Windows 10中的Wi-Fi？	如何解决Windows 10 Wi-Fi断开连接问题？	0
我被困在电气工程和医学预科之间。有什么建议吗？	vBulletin 5 Connect SEO真的表现不好吗？	0
如果我在大学的第一个月没有自我介绍，而其他人都已经有朋友了，我怎么能在我的班上和别人见面呢？	当我在人群（我的班级）面前讲话时，我开始结结巴巴，我该如何控制自己？	0
我想和我的朋友聊天，但我不知道该谈什么？	如果普通英国人不在乎携带武器自卫，为什么美国枪支游说，人们还在写这件事？	0
fork（）、vfork（）、exec（）和clone（）的实际应用是什么？	如何设计伸缩叉？	0
计算机网络的主要用途是什么？	什么是计算机网络？	1
以今天的价值计算，每小时运行一台街机游戏机的成本是多少？	曾经有过末日II游戏机吗？	0
巴基斯坦人民对2016年9月18日的Uri袭击有何看法？	巴基斯坦居民如何看待这次袭击？	1
斯波克最终是死于可汗之怒还是死于精神崩溃（上尉之血）？	成吉思汗是怎么死的？	0
唐纳德·特朗普为什么有橙色皮肤？	唐纳德·特朗普是否患有遗传性血色素沉着症？它会导致皮肤晒黑和脑病。	0
动物是否能够感受/体验人类未知的情绪？	动物和人类有相同的情感吗？	1
我有哪些方法可以提高我的书法水平？	我怎样才能有好的书法？	1
你希望美国人在访问德国之前能学到什么？	如何将Bitbucket与Microsoft Azure集成以构建和部署应用程序？	0
唐纳德·特朗普的胜利将如何影响印度？	唐纳德·特朗普将如何让印度受益？	1
什么是“印度邮政支付银行”？	在印度发送速递邮件的程序是什么？	0
兑换500和1000卢比纸币如何结束印度的黑钱？	禁止发行500卢比和1000卢比纸币是否有助于解决黑钱和腐败问题？	1
2016年有好的恐怖片吗？	2016年最佳恐怖片有哪些？	1
我怎样才能克服自杀念头？	我如何克服自杀念头？	1
在一架普通客机上，推迟飞机起飞必须有多大的风？	如果客机上的每个乘客都突然冲向飞机的一端，会不会对飞行造成任何阻碍？	0
什么是大门的关闭？	研究生学员的BPCL选择标准是什么？他们认为闸门标志更重还是他们更喜欢自己的测试？2015年公民之门的截止等级是多少？	0
多少运动可以降低血压？	降血压的快速方法有哪些？	0
我怎样才能在UGC英语文学网络考试中获胜？	教资会网络英语文学的书籍名称是什么？	1
古代印度教徒从印度航行到印度尼西亚。他们为什么不进一步航行去发现澳大利亚呢？为什么荷兰人没有从印度尼西亚发现澳大利亚？	当澳大利亚离印度很近的时候，为什么没有印度人去占领它？	0
为什么如果我们盲目地信任某人，他们总有一天会让我们失明？	我怎样才能成为一个沉默而令人印象深刻的人？	0
我们可以把肉和奶制品一起吃吗？	吃肉和奶制品可以吗？	1
每晚6小时的睡眠会阻碍14岁青少年的成长吗？	一个14岁的青少年需要多少睡眠？	0
马哈拉施特拉邦董事会第12届会议最好的纸质书籍有哪些？	为什么哥伦比亚广播公司的12班和10班的董事会考试有这么难的试卷？	0
为什么小天狼星必须在GOF向北旅行？	为什么小天狼星布莱克必须在GOF向北旅行？	1
无根是什么意思？	什么是-1的unroot？	0
我成年后如何学习骑自行车？	我怎么骑自行车？	0
天使投资者和风投之间有什么区别？	风投和天使投资人有什么区别？	1
如果印度和巴基斯坦陷入战争，会发生什么？谁会赢？	如果印度和巴基斯坦之间发生战争，对该国其他地区会有什么影响？	1
在婚礼上使用的最好的圣经经文是什么？	睡前读些什么好的圣经经文？	0
我们能阻止全球变暖吗？	我们有什么好办法阻止全球变暖吗？	1
如何在不使用根手机的情况下打开WhatsApp数据库（crypt8）？	我可以在笔记本电脑和手机上使用WhatsApp吗？	0
哪种死亡方式最可怕？	最具创新性的死亡方式有哪些？	0
我怎样才能买到耐用的笔记本电脑？	买什么最好的笔记本电脑能让我在大学里度过四年，而且问题最少？	0
在写一封公函时，如果一个人不知道一个女人是否结婚，那么应该用什么前缀称呼她？	如果我不知道一个女人是已婚还是单身，我该如何称呼她？	0
同时读两三本书可以吗？还是一次只看一本书？	对于第一次创业的创始人来说，三本必读的书是什么？	0
如何在TI-84 Plus中添加注释？	未经割礼的男性是否以较高的流速排尿？	0
机械工程专业女生的学习范围是什么？	女孩的机械工程范围是什么？	1
可口可乐和百事可乐哪个更好？	可口可乐和百事可乐哪一个更好？为什么？	1
为什么人们沉迷于色情？	为什么人们会沉迷于色情？	1
为什么被零除是错误还是未定义？	为什么零除是未定义的？	1
为什么我害怕做我自己？	为什么我害怕告诉我的男朋友我爱他？	0
国际象棋中最好和最有效的开口是什么？	国际象棋中最好的开局动作是什么？	1
我是印度人，想娶一个巴基斯坦女孩。我该怎么办？	我是一个巴基斯坦女孩，想在印度获得IIT的录取。我该怎么办？	0
语言学家如何看待电影的到来？	路易丝博士在电影《抵达》结尾对中国人说了什么？	0
有什么事情太严重了，不能开玩笑？	生活中有什么太严肃而不能开玩笑的呢？	1
回程证过期，但绿卡仍然有效。我能回到美国学习吗？	如果我已经拥有前往加拿大的有效V-1类访客签证（多次入境），我是否还需要另一个TRV以及学习许可？	0
有没有办法恢复ICAI的注册号？	我在2016年6月的CPT考试中不及格，但我想在12月再考一次。我需要再次注册吗？	0
在高影响因子、同行评议的国际期刊上发表的研究论文是否有助于你获得顶尖研究生院的录取？	如果你的整个城市突然决定听你的，会发生什么？	0
我想攻读机械工程硕士学位。对于其他工程专业的人来说，这有多困难？	为机械工程师学习编码是否困难？	0
在印度种植牙要多少钱？	印度德里的牙科植入物价格是多少？	1
两点电荷之间的导体对它们之间的库仑力有什么影响？	两点电荷之间的电介质如何影响它们之间的库仑力？	0
哪种木材胶最适合修补板球拍？	哪种胶水最适合修补板球拍？	1
新员工在Glu Mobile的第一天应该知道哪些事情？	在T-Mobile工作的第一天，新员工应该知道哪些事情？	0
婴儿平足的优点和缺点是什么？	平足的优点和缺点是什么？	0
《哈利波特》中的“脚板”一词是什么？	《哈利波特》中的脚掌是什么意思？	1
你每天（甚至周末）都在同一时间起床吗？	为什么早上醒来这么难？	0
面试中最具技术性的问题是什么？	在技术面试中，面试官会问什么问题？	1
安培、瓦特和伏特之间有什么区别？	30安培电子稳定控制系统可以处理多少伏电压？	0
我应该多久用Argan油按摩一次脸？显然，阿甘油对痤疮疤痕、健康/容光焕发的皮肤等非常有益。我应该在睡觉前多久在脸上按摩一次？我能不能先用Argan油，然后再用Liz Earle修护润肤霜，让肌肤健康、年轻、光彩照人？Plz帮助回答：）。	我应该用哪一种：橄榄油还是椰子油治疗粉刺？	0
政府工程学院是否严格遵守75%的入学率规定？	我能得到MITS gwalior 95%的JEE成绩和89%的cbse 12成绩吗？	0
什么是最好的“你知道你在加尔各答的时候……”陈述？	什么是最好的“你知道你在勒克瑙当”的陈述？	0
我将如何成为宝莱坞作家？	如何才能成为宝莱坞歌词作家？	0
是什么让伟大的电影如此迷人？	有情节转折的最佳电影是什么？	0
“运气”在日语中是什么意思？	文先生在电影中用日语说什么？	0
从Bluestone购买珠宝的可靠性如何？	我如何将黄金珠宝从法国邮寄到英国？	0
你经常关注哪些问题？	你认为一个人为了拥有不平凡的生活，可以经常问自己的最重要、最有力量的问题是什么？	0
为什么美国海军要穿越10000英里去威胁伊朗的小型海军？	2016年1月伊朗在波斯岛附近扣押美国海军巡逻艇的调查结果如何？	0
美国政党能驱逐成员吗？	我讨厌美国的两个政党，但我发现两害相权取其轻。这使我成为一个温和派还是一个不情愿的党员？	0
我如何开始一个苗圃？	我怎样开始苗圃？	1
在山区旅行时如何避免呕吐？	为什么人们坐公共汽车时会呕吐？	0
地球周围的空气有问题吗？	地球周围的光有问题吗？	0
Thich Quang-Duc怎么能不动一块肌肉就把自己烧死？	有关于僧侣Thich Quang-Duc自杀前的生活的书吗？	0
你听到的最好的引语是什么？	你今天听到的一句好话是什么？	0
我怎样才能把我的职业从软件工程师转到网络工程师？	我怎样才能从助理教授转为软件工程师呢？	0
在印度开发一款安卓应用需要多少钱？	在印度建立一个Android应用程序需要多少钱？	1
婆罗门人能吃鸡蛋吗？	为什么婆罗门不吃非素食食物？	0
为什么没有人在建Skylon？	如何在太空中建造植物？	0
我该如何阻止我的约克犬/柯基犬混血儿咬我的鞋子？	我如何防止我的狗咬垫子？	1
如果我在WhatsApp上阻止一个人，然后取消阻止他们，我会收到发件人被阻止时发送给我的消息吗？	我在哪里可以找到他们发送给我的被阻止的联系人消息？	0
什么是PAN卡？	获得PAN卡的最快方法是什么？	0
吃鸡蛋的人是素食者吗？	鸡蛋和牛奶是素食还是非素食？	0
如何为我的网站建立流量？	如何增加我博客的流量？	1
如何学习java编程语言？	什么是Java编程？如何学习Java编程语言？	0
我如何准备第十届ICSE理事会？	我如何准备第十届理事会考试ICSE？	1
你有没有和inidna的男人发生过性关系？	如果Aegon是Blackfyre，血鸦会有什么反应？	0
特朗普的支持者是相信他关于税收申报的主张，还是根本不在乎？	唐纳德·特朗普的支持者真的不在乎他的纳税申报表吗，还是他们只是容忍他的纳税申报表并放眼大局？	1
为什么钢比铁强？	哪些金属合金比钢强？	0
IT系统在商场、商场和商场中是如何工作的？	什么是公共政策的体制框架？	0
为什么牧场着装如此受欢迎？	牧场着装对你有好处吗？	0
我如何成为一名好老师？	你如何成为一名好老师？	1
自由主义者和社会自由的共和党人之间有区别吗？	自由主义者和极权主义者的区别是什么？	0
我如何判断某人是否聪明？	闲聊可以用来测试某人的智力吗？	0
我怎样才能摆脱家里的小黑蜘蛛？	我怎样才能除掉家里的白蜘蛛？	0
保护政客的特勤局特工是由他们的政治派别选择的吗？	特工的政治观点会影响他们的职责吗？	1
智商高的人通常会发现其他人“愚蠢”或迟钝。我能从日常生活中得到一些具体的例子吗？	如果愚蠢的人加入quora，这会让quora变得愚蠢吗？	0
我们为什么不把太阳能光伏发电的直流电直接连接到高压直流输电系统呢？	既然印度有自己的“一个国家一个电网”的概念，为什么我们不能给所有的暖通空调线路装上高压直流电源，这样传输损耗就会大大减少？	0
为什么谷歌没有像在奥运会上那样，为残奥会创造同样的功能？	肝脏的主要功能是什么？	0
什么样的疾病在成年女性中比男性更常见？	尊敬的专家们：男性前列腺疾病的常见症状是什么。男人要治愈它首先要做的是什么。？	0
FDI的自动路径、FIPB路径等的含义是什么？在印度经济中，每个入口的利弊是什么？选择一个而不是另一个的理由是什么？	外国直接投资和外国直接投资之间有什么区别？	0
批判性思维有助于燃烧卡路里吗？	思考能燃烧卡路里吗？	1
有哪些方法可以删除我的雅虎邮件帐户？	有哪些方法可以永久删除我的雅虎邮件帐户？	1
[math]（a+b）^3[/math]的公式是什么？	我怎样才能在数学上取得好成绩？	0
一家公司如何在盈利的同时仍保持负现金流？	营运资本的变化如何影响公司的现金流？	0
MBA对我的职业生涯有帮助吗？	MBA对我有什么帮助？	0
为什么Quora moderation会删除有关Quora moderation的问题？	什么样的问题会在Quora上被删除？	0
如果我的男朋友从不给我时间，我该怎么办？	如果我的女朋友承诺永远不会离开我，她爱我胜过爱我的妈妈，她为了别人离开了我，我该怎么办？	0
设计国旗背后的思维过程是什么？	你们国家国旗背后的故事怎么样？	1
奇迹：如果有的话，瓜达卢佩夫人的蒂尔玛背后的科学奥秘是什么？	德里铁柱背后的秘密是什么？	0
特朗普的外交政策具有破坏性吗？	11班的优等生是如何学习的？	0
游泳池过滤器是如何工作的？	海水游泳池是如何工作的？	0
未来10-20年，工作和工作将如何变化？	在未来10-20年内，工作和工作将如何变化？	1
创业加速器使用哪些工具来跟踪公司的进展？	哪些工具或方法可用于跟踪您的追随者/粉丝点击“喜欢”并评论您/您公司帖子的状态更新的频率？	0
一个人如何坠入爱河？	如何坠入爱河。？	1
美国手语和英国手语之间有什么有趣的区别？	对于一个没有聋哑朋友的“有听力”的人来说，想要学习他们国家最常用的手语（即我的英国手语）是不是很奇怪？它与学习第二种发音语言相比，还是你认为不同？我对“听”和“听不见”的意见很感兴趣。	0
全球变暖存在吗？	全球变暖是真的还是恶作剧？	1
什么样的智商会让你的平均成绩超过3.5分？	你能找出这个问题答案中的错误吗？	0
如果优步司机不能提前看到他们的目的地，如果他们接受一个非常远的目的地会发生什么？	Uber什么时候停止让司机看到车手的目的地了？	0
马克思说：“宗教是人民的鸦片”。那么，印度共产党是如何以及为什么转变为反印度教的呢？	当共产主义意识形态反对所有宗教时，为什么印度左翼被称为反印度教？	0
你最喜欢说什么？为什么？	你最喜欢的格言是什么？	1
为什么种姓制度在印度持续存在？	为什么种姓制度在印度仍然存在？	1
从澳大利亚向美国发送传真的最佳方式是什么？	我怎样才能从澳大利亚发传真到美国？	1
机器系统中的数据、信息和知识有什么区别？还是有区别？	基于知识的系统和专家系统有什么区别？	0
理想的电压表和电流表的电阻是多少？	我们在实验室使用的电流表和电压表的实际电阻是多少？	0
首次访问几内亚的游客会注意到哪些意想不到的事情？	第一次来尼泊尔的游客会注意到哪些意想不到的事情？	0
印度新发行的2000卢比纸币将有一个纳米GPS芯片，这是真的吗？	印度新的高面额货币正在嵌入GPS纳米芯片的事实有多真实？	1
柏林公共交通的最佳应用程序是什么？	柏林最好的公共交通应用程序是什么？	1
我正在考虑制作并出版一部以拟人口袋妖怪为主角的连续剧，但我如何做到这一点而不侵犯版权呢？	你觉得多哥漫画系列怎么样？	0
如果有的话，棉卡其裤洗后会缩水多少？	为什么棉花洗后会缩水？	0
既然英国已经投票退出欧盟，现在会发生什么？	[脱欧投票前]英国退出/留在欧盟的利弊是什么？	0
谁是你的榜样，为什么？	谁是你的榜样？为什么？	1
你经历过睡眠麻痹吗？那一刻有多残酷？	你有一个有趣的睡眠麻痹的故事可以分享吗？	0
在英国伯明翰，作为一名研究生，每月有多少钱足够生活？	一个学生在英国伯明翰的生活需要多少钱？	1
你是怎么教你的孩子不要撒谎的？	教孩子们不要撒谎的好方法是什么？	1
密涅瓦商学院与美国其他营利性大学有何不同？	当许多其他盈利性大学都是不良投资时，为什么密涅瓦大学会成功？	1
如何为我的软件初创公司获得客户？	为软件启动获取客户端的最佳方法是什么？	1
为什么等离子体被认为是物质的第四种状态？	等离子体被认为是物质的第四种状态吗？	0
如何从Quora中删除我的问题？	如何从Quora中删除问题？	1
印度河流域和哈拉帕文明灭绝的原因是什么？	谁对印度河流域文明的崩溃负责？	1
圆是无限边的正多边形吗？如果是，则讨论其属性和内角。	可以说圆有无限边吗？	1
市政合作或供水行业的初级工程师在州一级政府工作中能挣多少钱？	一名初级CS研究生在美国完成硕士学位后平均挣多少钱？	0
人类什么时候开始给自己命名的？名字背后的历史是什么？非人类物种使用名称吗？	历史上我们什么时候开始给人起名字的？	1
水过滤一氧化碳吗？	一氧化碳死亡是痛苦的吗？为什么？	0
新闻网站能看到我通过Feedly订阅他们的提要吗？他们看到了什么信息？（电子邮件地址、姓名等）。	为什么Quora没有“先看”功能，用户可以选择填充Quora提要的内容？	0
人类害怕人工智能是因为它没有灵魂吗？	科学证明灵魂存在吗？	0
为什么我们的宝莱坞产业有这么多穆斯林？	印度电影业为什么会有这么多穆斯林？	1
唐纳德·特朗普有多聪明？	唐纳德·特朗普的基地是谁？他为什么受欢迎？为什么人们投票给他？为什么人们喜欢和支持他？	0
如果记不起iCloud密码，该怎么办？	如何恢复iCloud密码？	1
Quora display现在是否根据用户所在国家/地区的主题发展趋势？	Quora中的趋势主题是否特定于位置？	1
作为一名从印度前往意大利佛罗伦萨的国际学生，我必须携带哪些必需品？	作为一名从印度前往意大利佛罗伦萨的国际学生，我必须随身携带哪些必需品？	1
我在哪里可以在线观看《行尸走肉》第8季？	我在哪里可以在线观看《行尸走肉》第七季？	0
所有流式Hadoop解决方案：Flume、Spark（Datatricks）、Storm、Kafka（Confluent）和Malhar（Datatorrent）之间有什么区别？	与Storm相比，使用DataTorrent有哪些优势？	0
什么是最好的用户体验简历？	什么是最好的简历搜索网站？	0
哪一个是最好的电影下载站点？	有没有秘密网站可以下载泄露的电影？	0
你会因为偶然吃了几粒杂草而兴奋吗？	吃野草最好的方法是什么？为什么？	1
世界上最古老的桥是什么？	世界上最古老的桥是什么？它是如何设计和建造的？	1
我怎样才能得到满意的性爱？	女同性恋性行为和异性恋性行为一样好吗？	0
谁将赢得2014年世界杯？	比赛即将开始，哪个国家最有可能赢得2014年世界杯？哪个队最强？	0
艾哈迈达巴德，我如何准备迎接城市级的思考和学习挑战？	我应该采用什么样的芬兰移民程序？	0
赞成/反对贾利卡图的理由是什么？您个人对此有何看法，以及中心和SC处理此事的方式？	什么是最好的无神论论据？	0
我怎样才能获得绿卡在美国生活和工作？	我怎样才能得到绿卡？	1
羊毛衫洗后会缩水还是会拉长？	你必须在毛衣下面穿衬衫吗？	0
我们应该怎样做才能成为最好的软件开发人员？	要成为一名优秀的软件开发人员应该做些什么？	1
我现在20岁，是一名毕业生。但是我在家已经两年了&什么也没做。我现在的行动计划应该是什么？	纳伦德拉·莫迪什么时候把他的称呼从“米特伦”改为“拜奥·奥贝诺”？	0
拥有研究生学位的印尼工人的平均工资是多少？	加尔各答理工学院毕业生的平均工资是多少？	0
我怎样才能找到创业导师？	我该如何邀请别人做我的导师？	1
中长跑运动员应该如何将重量训练纳入他们的整体训练计划？	一个人如何在不增加质量的情况下变得更强壮？	0
为什么库拉岛上有这么多印度人，为什么他们这么讨厌？	为什么Quora在印度如此受欢迎？	0
奈特赖布尔的化学工程职位安排如何？	奈特-赖布尔化工厂怎么样？	0
如何保护我的应用程序名，使其不被其他人使用？	c编译的快捷方式？	0
如何在安全模式下启动华硕电脑？	在OC模式下运行GPU总是安全的吗？	0
有可能发明时间机器吗？	我们能创造一个时间机器吗？	1
在英国，《2014年移民法》的含义是什么？	在英国，《2016年移民法》的含义是什么？	0
FDA审查保密协议通常需要多长时间？	我如何准备FDA审核？	0
如何使草酸溶于水？	我们如何制造水溶性聚合物？	0
和平号家族的家族根源是什么？	你有没有因为比较而嫉妒过兄弟姐妹？	0
哈佛大学课程：HBTM课程的一般购物建议是什么？	哈佛大学课程：SCRB课程的一般购物建议是什么？	0
OYO房间的质量和可靠性如何？	有人体验过OYO房间吗？使用OYO房间是否是一次很好的体验？	1
关于全球微生物组学有哪些好文章？	英国退出欧盟的主要原因是什么？	0
你每天使用什么网站？	哪些网站值得每天访问？	1
基础电气工程最好的书是什么？	第一年的基础电气工程应该参考哪本书？	0
什么是让你快乐的小事情？	让你快乐的最好的事情是什么？	1
2000卢比以下/左右最好的耳机是什么？	在2000卢比或35美元以下，哪种耳机最好？	1
为什么Arvind Kejriwal总是责怪BJP？为什么他辞去了在德里的CM职位？	为什么Arvind Kejriwal在过去质疑Pranab Mukerjee的诚实时会赞扬他？	0
你如何定义一个完整的人？	你如何定义一个人？	0
为什么新自由主义者和大公司觉得有权签署自由贸易协定，而根据他们自己的逻辑，没有什么是免费的？	既然对冲基金经理有钱购买经纪公司，而且他们可以拥有该公司，并且可以免费交易，为什么他们还要向经纪公司支付佣金？成为一名股票经纪人，这样你就可以免费交易，这不是更便宜吗。	0
如果唐纳德·特朗普赢得选举会发生什么？	如果总统选举的两名候选人中有一人在选举日上午去世，会发生什么？	0
100平方英尺碾压混凝土需要多少水泥？	280平方英尺6英寸厚需要多少水泥？	0
是什么让塔塔集团主席塞勒斯·米斯特里辞职的？	塞勒斯·P·米斯特里被免去塔塔集团主席职务的原因是什么？	1
果阿哪一个地方最好和朋友一起去？	我们计划去果阿三天，哪一个地方最好？	1
Koundynya Rishi是谁？	为什么Koundynya Rishi如此重要？	0
如何使用保鲜膜来减肥？	在家里使用透明塑料包装袋减肥安全吗？	1
阿拉巴马州无照驾驶的处罚是什么，与马萨诸塞州的处罚相比如何？	阿拉巴马州无照驾驶的处罚是什么，与缅因州的处罚相比如何？	0
在黄金海岸哪里可以买到美味的纸杯蛋糕？	在黄金海岸哪里可以品尝到独特的纸杯蛋糕？	1
哪些独立乐队值得听？	我对听独立音乐感兴趣。哪些乐队能说服我试一试？	1
是什么让一个人爱上你？	你能让某人爱上你吗？	0
我怎样才能在Music.ly上介绍某人？	我如何在Music.ly上获得硬币？	0
为什么公园和娱乐会成功？	为什么公园和娱乐设施如此无聊？	0
哪些顶级移动应用开发公司开发了移动和平板餐厅应用？	哪些服务公司擅长为初创企业建立外包的移动应用程序开发团队？	0
在困难时期，什么给了你希望？	是什么给了你人性的希望？	1
你会在选举失败后离开政界吗？	如果你的政治代表当选后变得富有或更富有，你会没事吗？	0
印度学生在美国进入MS课程的程序是什么？	印度人在美国进行高等教育（MS）的程序是什么？	1
人们知道你在Instagram上查过吗？	Instagram（产品）：如果我不记得密码，又不知道用于设置帐户的电子邮件地址，我如何登录Instagram？	0
跳绳能增加你的身高吗？	增加身高的最佳和最快的方法是什么？	1
光是由什么组成的？	光到底是由什么构成的？	1
我应该今年考西德纳姆还是明年考JB，2016年CET考试成绩为99.83分？	我有2.5年的经验，计划明年进行CET，目标是JBIMS MMS。JBIMS是否选择经验超过3年的候选人？	0
西班牙的大多数年轻人能流利地用英语交流吗？	大多数意大利年轻人能流利地用英语交流吗？	0
门萨智商测试的可靠性如何？他们测量的是什么样的智力？	你怎么知道自己是否真的聪明？	0
TVF三联第三集午夜播放哪首歌？	在TVF第五集的结尾播放哪首歌？	0
如何确定液体体积的公式？	如何确定剩余体积的公式？	0
我如何处理常见的尴尬？	我该如何处理我的尴尬？	1
下载torrent视频时如何观看？	BD、HD、720p和1080p在质量上有什么区别？	0
我怎么能得到下面这些家伙的屁股？	我怎么才能自然地得到一个更大的屁股？	0
任何人都不能说出自动相关监视（合同）ADS-C飞行跟踪系统的安装成本吗？	Allen motorhead书籍PDF如何下载？	0
evga gtx 1080、华硕gtx 1080和msi gtx 1080之间的区别是什么？	为什么我爸爸要把他所有的薪水都花在我嫂子和她的孩子身上？	0
如何改进Quora上的文字？	如何提高我在Quora上的写作能力？	0
阴道内部感觉如何？	被唤醒的阴道感觉如何？	0
对男人们：男人们还会把他们的电话号码发给你，让你给他们打电话吗？老派骑士精神还是显而易见的球员？	男人：你怎么看“男孩不哭”和“男人不表露感情”？	0
在医学研究中，孟加拉国和中国哪个更好？	我如何准备10级案例板？在未来的研究中，哪一个是更好的选择？工程法还是医学？	0
在美国，哪个词最受尊敬：清洁工、管家还是女佣？	是“美国公司”还是“美国公司”？	0
我现在能做些什么来帮助阿勒颇人民？	我能做些什么来帮助阿勒颇的局势？	1
你对印度禁止发行500和1000卢比纸币有什么看法？	印度禁止发行500和1000卢比纸币会有什么结果？	1
哪一个是劳伦斯县附近的好的住院药物和酒精康复中心？	日内瓦县附近的一个好的住院药物和酒精康复中心是什么？	0
你认为希拉里·克林顿的肺炎会影响选举吗？	希拉里·克林顿提前退出9/11仪式对她的竞选活动有多大影响？	0
在纽约市，一个家庭每年能靠12万美元生活吗？	在纽约，一个家庭靠每年15万美元能过得舒服吗？	0
如何从metro PC帐户获取文本记录？	如何从metro PC获取旧的通话记录和短信？	1
唐纳德·特朗普在他的第一次新闻发布会上公开反对主流媒体对吗？	唐纳德·特朗普在墨西哥举行的新闻发布会上是否有一根发夹挡住了他的头发？	0
你认为费德勒、纳达尔、德约科维奇、默里、瓦林卡、德尔波和西里奇在网球界最有潜力的位置上排名如何？	你如何评价费德勒、纳达尔、德约科维奇、默里、瓦林卡、德尔波和西里奇在体育史上的成就和潜力？	1
为什么没有人看到无限和无限之间的区别？	嗨，朋友们！我的体重是100公斤。我怎样才能在一年内把体重提高到70-75？	0
哪家在线辅导机构最适合CAT准备？	在线辅导是否比去时间和PT教育等机构进行CAT准备更好？	0
如何以低预算旅行？	我如何在低预算的情况下旅行？	1
Quora是什么意思？	Quora这个名字到底是什么意思？	1
我怎样才能停止不安全感？	我怎样才能停止对自己的不安全感？	1
为什么可乐能帮助我缓解月经痛，而不是所有的医学建议？	缓解月经痛最好的坐卧姿势是什么？	0
如果我不吃早餐和午餐，一整天只吃晚餐和两杯咖啡，我会减肥吗？	如果我一整天都在咀嚼和吐痰，我吃的唯一一顿丰盛的饭就是晚餐，而我在锻炼，为什么我没有减肥？	0
我如何在两个月内学会日语？	你是怎么学日语的？	0
你多久喝一次咖啡（以咖啡为主）饮料？	你多久喝一次咖啡？	1
如何从Quora中删除我的问题？	如何从Quora中删除我自己的问题？	1
我如何处理那些利用我的清白的人？	欧洲有折扣吗？	0
2014年有哪些美国公司被推荐投资？	在加拿大，进入美国投资银行公司的最佳大学是什么？	0
绞死是痛苦的吗？	一个人被绞死后会发生什么？	0
比利时：哪些历史学家不同意丘吉尔在1940年5月向德国投降后对比利时国王利奥波德三世的文学处理？	为什么丹麦在3小时内就向纳粹德国投降了？	0
如何在Mac上使用印度的Spotify？	如何在印度使用Spotify？	0
人们怎么看安吉尔名单？	与AngelList发生了什么共谋（如有）？	0
葡萄酒：在希尔德斯堡地区最好参观哪些酒厂？	希尔兹堡最好的酒庄是什么？	1
人类历史上最重要的时刻是什么？	2017年12月，金奈最美好的时刻是什么？	0
喀拉拉邦最好的蜜月目的地是哪一个？	喀拉拉邦夏季蜜月旅行的最佳蜜月地点是哪里？	1
我如何减肥？	我如何吸收它并减肥？	1
哪一款是最好的iPhone6手机壳？	最好的iPhone4手机壳是什么？	0
在伦敦的高盛工作是什么感觉？	在高盛工作是什么感觉？	0
如果我从网站下载MIUI8，那么我会得到进一步的更新，它会成为我手机的根目录。我有红色的音符3吗？	如果我在android手机上更新一个应用程序，它会增加应用程序的总下载量吗？	0
为什么约翰·纳什患有精神分裂症？	约翰·纳什的孩子是谁？	0
我应该害怕我的父母吗？	我的父母会害怕我做得比他们好吗？	0
我如何准备从11月开始的2017年MBA CET？	从2015年6月开始准备，我能在2017年IITB获得CSE吗？	0
所有武装党卫队都犯了反人类罪吗？	什么是diagtrack什么是diagtrack？	0
我如何准备在Jack in the Box作为软件开发人员实习的面试？	在谷歌的软件工程师面试中，我应该期待什么？我应该如何准备？	0
为什么人们会在Quora上写很长的答案？	为什么Quora上的人会写很长的答案，即使问题不一定需要答案？	1
史努比·多格和威兹·哈利法之间有什么关系？	史努比狗和巫师哈利法有什么关系？	1
肥皂浮渣形成的平衡化学方程式是什么？	在德里，哪家公司是一家很好的创业公司？	0
石油和天然气行业使用的管道类型有哪些？	他们在石油和天然气行业的日常运营中使用什么软件？	0
密歇根州门罗县附近的一个好的住院药物和酒精康复中心是什么？	马里兰州巴里县附近的一个好的住院药物和酒精康复中心是什么？	0
我如何才能看到谁观看了我的Instagram视频？	我怎样才能看到谁看了我刚在Instagram上发布的视频？	1
我的头发只在淋浴时掉，但不是在淋浴后。为什么？	为什么我洗澡时头发会掉下来？	0
如何临时停用WhatsApp帐户？	自从我的手机丢失后，我已经屏蔽了我的SIM卡，但我的Whatsapp帐户仍在工作。如何停用我的帐户？	0
哪个更好：超级AMOLED还是TFT？	哪个电视面板比VA或IPS更好？	0
《个人财产安全法》是什么？新斯科舍省与纽芬兰省有何不同？	《个人财产安全法》是什么？新斯科舍省与阿尔伯塔省有何不同？	0
我应该使用Swift还是Objective-C来学习iOS开发？	iOS学习哪一个更好：Swift还是Objective-C？	1
纳伦德拉·莫迪的饮食是什么？	纳伦德拉·莫迪肥胖吗？	0
有哪些中国音乐和英文歌词的好歌？	哪一首英文歌曲节奏快？	0
Java中的正则表达式是什么？	什么是“not”的正则表达式？	0
阿什·阿罗拉的《物理星系》怎么样？这与JEE有关吗？	IIT-JEE的物理银河系讲座有多有效？	0
水肺潜水：一个人在50英尺的高度能呆多久而不需要减压？	如果我有一周的时间，我应该去哪个国家，危地马拉还是尼加拉瓜？其中有什么我不应该错过的？哪一种潜水效果更好？	0
哪个国家的司法系统的未决案件最少？	我们如何在印度司法系统中使用大数据分析？此外，我们如何在网上获得有关未决案件的详细信息？	0
建筑面积和地块面积有什么区别？	最小建筑面积是多少？为什么最低建筑面积是法定要求？	0
很多女人告诉我，她们更喜欢男朋友而不是女朋友。常见的原因是什么？	我是一个女孩。我和我最好的朋友（一个男人）有感情。我不爱他，但当他把迷恋放在首位而不是我时，我会嫉妒。我在经历什么？	0
环绕式前照灯和投影仪前照灯之间的区别？	我完全了解核心java，但我在解决一个问题时遇到了困难，即使我不知道如何找到1到100之间的素数。我该怎么办？	0
埃伊在维苏特，布拉好吗？位置好吗？什么样的公司招聘EEE毕业生？	贝拉，埃伊在VSSUT怎么样？	1
如果你看到名人，你如何接近他/她？	接近名人的最佳方式是什么？	0
你什么时候开始学习编码的？如果有人想非常擅长编码，他或她必须在很小的时候就开始学习，这是真的吗？	学习C#最好的方法是什么？	0
名称空间在Java中是什么意思？	在Java中“$”是什么意思？	0
莫迪和希特勒有什么区别？	莫迪与希特勒有何不同？	1
生活的目的是什么？	你如何找到你的人生目标？	0
如何通过我的注册手机号码或电子邮件ID在IRCTC中找到我的用户名和密码？	为什么我不能使用我的id和密码登录IRCTC？	0
Jio如何在3G手机中工作？	如何在3G设备中使用Jio sim卡？	1
海得拉巴最好的godrej空调维修中心是哪家？	海得拉巴最好的IFB空调维修中心在哪里？	0
服务员花多少时间来点菜？	你如何克服离婚后不能花那么多时间陪孩子的问题？	0
我怎么才能不觉得自己不喜欢和别人说话呢？	我如何与我不喜欢的人交谈？	0
将Dell Inspiron 530恢复出厂设置的最佳方法是什么？	如何将Dell Inspiron 1525恢复到出厂设置？	1
现存的10种爬行动物是什么？	为什么我看不到爬行动物抓它们的皮肤？	0
创新传播：有什么样的意见领袖可以影响年轻人？	绒毛中的扩散是什么？	0
有关于印度在吉布提的拉哈特行动的电影或纪录片吗？	印度有哪些S级电影？	0
澳大利亚术语“希拉”是如何产生的？	澳大利亚术语“希拉”是什么意思？	1
没有统一的民法典，印度怎么可能成为一个世俗的世纪？	为什么统一民法典的实施很重要？	1
intezern的素因式分解是A×A×B×C，其中A、B和C都是不同的素因式分解。N有多少个因子？	整数N的素因子分解是A×A×B×C，其中A、B和C都是不同的素整数。N有多少个因子？	1
循环装置的熵变是否总是零，无论是可逆的还是不可逆的？	我们可以通过假设过程可逆和答案相同来求不可逆过程的熵。我能用同样的方法来计算绝热过程吗？	0
ProActiv的副作用是什么？	使用Proactiv有什么副作用？副作用如何治疗？	1
《不切实际的小丑》的演员有哪些种族？	你对《不切实际的小丑》（电视连续剧）有何评论？	0
祝穆斯林朋友生日快乐的适当方式是什么？	当祝福一位老朋友生日快乐时，用他们过去使用的化名称呼他们可以吗？	0
百分之多少的人口有两种不同颜色的眼睛？	虹彩异色（两种不同颜色的眼睛）是如何工作的？	0
到目前为止，你的生活教会了你什么？	生活教会了你什么？	1
一个没有做过生殖器手术的变性女同性恋怎么能找到伴侣？	作为一个变性人，你会如何回应一个不相信你是变性人的人？	0
你在Quora上问了多少问题？	在Quora上问了多少问题？	0
没有任何训练，我怎么能跑5公里？	我如何在没有太多训练的情况下跑5公里？	1
在你的助行器上打网球有什么优点和缺点？	在步行者身上附加网球的利弊是什么？	1
工程师最好的接送线是什么？	哪一条皮卡线从未让你失望过？	0
DHL发出的“带快递”的信息是什么意思？	敦豪速递有哪些参考资料？	0
为什么iMessage不能在我的iPhone和MacBook之间同步？	为什么我的iPhone不能连接到我家的WiFi？	0
HND海洋工程的优点和缺点是什么？	轮机员是否获得NRI身份？	0
为什么文科学生只是重复相同的“咒语”，而没有任何批判性的思考？	炸药拥有专利的原因是什么？	0
为什么德州游骑兵队对今天的执法很重要？	德州游骑兵的职责是什么？他们如何与其他执法机构互动？	1
如何从snapchat获取旧消息？	我应该如何远程破解Snapchat消息？	0
什么是人性？什么是人权？	我们所说的人权是什么意思？	1
《医生世界》中的特塞拉特是什么？它的作用是什么？	为什么我如此悲伤和孤独。？	0
如何从驾驶记录中清除积分，以获得较低的保费？	我如何从我的驾驶记录中清除积分，以便在加利福尼亚州获得较低的保费？	0
业余无线电和CB无线电有什么区别？	火腿收音机和CB收音机有何不同？	1
哪家公司有文化？	WhatsApp的公司文化是什么样的？	0
手淫会导致锌的流失导致食欲下降吗？	自慰会导致蛋白质的损失吗？	0
什么是Kaufmich.com？	superbcrew.com做什么？	0
巴基斯坦芒果vs印度芒果，哪一种最好？	芒果尝起来像什么？	0
如何查看个人Instagram？	我可以查看个人Instagram吗？	1
瑞士有什么样的经济，挪威有什么不同？	瑞士有什么样的经济，比利时有什么不同？	0
对于一名计算机工程硕士的学生来说，你认为选择计算地球物理学的研究或职业道路的未来会是怎样的？	我是第八个sem。CSE学生。我应该选择哪条道路作为职业，或者我应该选择哪门课程来获得一份好工作？	0
你最希望的自然死亡原因是什么？	你最不希望的死因是什么？	0
为什么第三次世界大战不可避免？	第三次世界大战即将来临吗？	1
自由落体速度和纳米热效应是否证明了9/11是一场骗局或内幕交易？	遗传算法基本上不是从无到有地生成信息吗？这难道不证明算法的存在是为了创建信息吗？还是全是骗局？	0
如果使用SDS-page，所有蛋白质上的电荷是否相同？	如何使用SDS-PAGE检测低分子蛋白（<10 kDa）？	0
红头发和姜黄色有什么区别？	我怎样才能得到姜黄色的头发？	0
海上平台如何处理从陆地到陆地的杂货和小货物运输？	海上石油平台停止钻井后会发生什么？	0
你如何通过应用程序来赚钱？	我如何在应用程序上赚钱？	0
如果没有项目提案，我可以申请艾伯塔大学的网络互联吗？	我能用82%英镑进入艾伯塔大学吗？（以33%的及格率）我来自印度	0
叙利亚内战到底是怎么回事？	叙利亚内战是什么？	1
你能推荐一款15k以下的最划算的手机吗？	15k以下哪款手机最好？	1
这6种母酱是什么？使用它们的食谱是什么？	这6种母酱是如何用于烹饪的？	1
后悔生了孩子是什么感觉？	你有没有后悔生了孩子？	0
白人女性觉得亚洲男人有吸引力吗？	男人会被白发或白发的女人吸引吗？	0
准备CA期末考试理论部分的最佳方法是什么？	准备CA最终第一组论文的最佳方法是什么？	1
我在哪里可以销售商业创意？	风险投资和投资者推介：我如何推销我的产品创意？	1
飓风桑迪（2012年10月）：当人们准备迎接风暴袭击时，商店里卖的是什么？	飓风桑迪的影响是什么？	0
了解股票市场的方法有哪些？	了解股票市场投资和购买哪些股票的最佳方式是什么？	1
使用塑料餐具进食有害吗？	吃葵花籽壳不好吗？	0
Quora：如何在Quora上提问，使其不会被标记为需要改进？	我似乎不能再问什么了。为什么Quora总是把我所有的问题都标记为需要改进？	1
邓诺创造了宇宙吗？	考虑到“避开区”，以及地球与大多数星系处于同一平面的事实，我们如何知道它的大小和形状？	0
印度铁路的火车票检查员（TTE）的工资是多少？	印度铁路应该私有化吗？	0
你听过的最有趣的笑话是什么？	你听过的最好的笑话是什么？	1
有什么证据可以证明上帝的存在吗？如果是，这些是什么？	有没有证据表明没有上帝？	1
什么是最好的快速减肥方法？	快速减肥的最佳方法是什么？	1
变性男人和变性女人的区别是什么？	变性男人和变性女人有什么区别？	1
“参加考试”或“进行考试”对学生正确吗？	你写作、参加还是参加考试？	0
外国人在韩国可以做什么工作？	外国人如何在韩国找到工作？	1
为什么有些人的答案没有评论的地方？	为什么有些答案没有评论选项？	1
汉堡包配什么配菜？	扁豆汤的配菜是什么？	0
什么是最好的智能手机科技产品？	什么是最好的可用技术小工具？	1
磁铁可以用来清理太空碎片吗？	如何清理地球轨道上的空间碎片？	0
当上帝创造世界时，他在哪里？	上帝在哪里？	0
什么是增值税？增值税和营业税的区别是什么？	什么是增值税？	0
我在8月25日收到了jio sim卡，现在是9月4日，但sim卡仍未激活。我该怎么办？	为什么Java程序员戴眼镜？	0
如何加快我的Internet连接？	如何加快我的互联网连接速度？	1
当我乘坐当地火车（孟买）旅行时，有人从我口袋里偷走了我的手机，我的手机被取回的几率有多大？	在孟买当地火车上丢失的手机有什么可能找回？	1
如何在其他人不知道您打开SnapChat消息的情况下打开该消息？	如何删除他人保存的snapchat消息？	0
纽约最有价值的米其林星级餐厅是什么？	纽约最好的希腊餐馆是什么？	0
你怎么能找到你的手机号码？	我如何找到我的手机号码？	1
假设α和β是方程3x^2-5=0的根，那么方程的根是2alpha-1/β，2alpha-/α？	方程[math]x^2+3x-10=0[/math]的根是[math]\alpha[/math]和[math]\beta[/math]，其中[math]\alpha<\beta[/math]。[math]\alpha-1[/math]和[math]\beta+2[/math]是什么方程的根？	0
对500卢比和1000卢比纸币的禁令将如何影响印度经济？	对500/1000面额的禁令如何影响印度经济的各个领域？	1
为什么马来西亚没有发展成为像新加坡这样的第一世界国家？	除了石油，马来西亚是如何成为一个发达国家的？	0
皈依前谁是耆那教？婆罗门、克沙特里亚斯、毗湿亚斯还是舒德拉？	舒德拉人能读吠陀吗？	0
佛蒙特州为什么如此自由？	佛蒙特州有什么文化吗？	0
你会继续做一件你认为必须做的事情，而没有任何人理解和支持吗？	出租破产的公寓？	0
我们如何过有意义的生活？	我如何过有意义的生活？	1
在魔兽世界里买黄金最安全最便宜的地方是哪里？	购买WoW gold安全吗？	0
tcs bps的薪酬结构如何？	哪一个更好的IBM GBS或TCS BPS？	0
有人猜测，特朗普正试图在选举结束后为自己做准备，如果他输了，他将在选举结束后开始一场右翼脱口秀。你怎么认为？	对于一个非常早期的创业公司，什么事件表明现在是开始谈论股权并联系律师的合适时机？	0
你怎么能扩大你的阴茎？	我怎么能有一个大阴茎？	1
您对Lyf手机的评价如何？	印度如何为满足沙文主义者的集体良知而将克什米尔作为人质辩护？	0
奥兰多6月份的天气怎么样，与1月份的天气有什么不同？	奥兰多六月的天气怎么样，与十一月的天气有什么不同？	0
什么是最好的免费和合法的音乐下载网站？	哪些是最好的免费应用下载站点？	0
对于成为会计学教授的人来说，典型的职业道路是什么？	成为地理学教授的典型职业道路是什么？	0
如何删除您在Quora上提出的问题	是否可以永久删除Quora问题？	1
如果你怀疑你的配偶作弊，你会怎么做？	你如何处理一个不忠的配偶？	0
自学吉他最好的方法是什么？	我怎样才能自学弹吉他？	1
除了电子商务、电影和工作之外，还有什么推荐引擎吗？你如何着手制作一个独特的？	有没有可能在不需要知道编码的情况下，以极为经济高效的方式创建一个电子商务网站？一个人会使用什么平台？	0
哪一个是购买更大尺寸品牌鞋的最佳地点？	分数要求在wb JEE中达到1000级？	0
什么颜色最值得信赖？	最常见的M&M颜色是什么？	0
拳击手每场比赛挣多少钱？这是他们的主要收入吗？	拳击手和MMA拳击手从不同类型的比赛中获得多少固定金额、门票收入和按次付费？	0
我突然被Gmail注销了。我记不起我的Gmail密码了，才意识到恢复邮件已经不存在了。我能做什么？	如果忘记了Gmail密码，当你记不起恢复信息时，你如何找到一个旧的Gmail密码？	1
为了保持今天的更新，你必须学习的最好的编程语言是什么？	（在你看来）最好学的编程语言是什么？	1
在摩纳哥，信用卡在小企业和餐馆的接受程度如何？	在以色列，信用卡在小企业和餐馆的接受程度如何？	0
路易斯·巴斯德在微生物学方面的贡献是什么？	约瑟夫·李斯特在微生物学方面的贡献是什么？	0
为什么Ryan Lochte会谎称在2016年力拓被抢劫？	为什么Ryan Lochte会谎称被警察抢劫？	1
Java开发人员和维护数据仓库的最佳工作是什么？	作为一名ECE毕业生（他对电子学不太感兴趣），我现在应该选择哪一份工作，java开发人员还是数据科学家？	0
世界其他国家如何看待共和党？	世界其他国家如何看待你们的国家？	0
为什么爱尔兰人和苏格兰人不愿意恢复盖尔语，使之成为以色列人日常使用的语言？	既然特朗普和彭斯入主白宫，他们能强迫神创论与进化论并驾齐驱吗？	0
你如何成为一名军事飞行员？	我怎样才能成为一名军事飞行员？	1
印度有多少州和联邦领土？	目前印度有多少州和联邦议会？	0
2017年最佳网络托管黑色星期五交易是什么？	2016年黑色星期五最佳网络托管交易在哪里？	0
有史以来最好的小说是什么？	最好看的小说是什么？	1
英格兰诉。威尔士-谁会赢？	谁将赢得英格兰对威尔士的比赛？	1
我怎样才能更好地集中精力学习？	我怎样才能专心学习呢？	1
我在东帝汶澳大利亚基地公司有一份工作，在我8个月的工作之后，我可以得到一份公关。我的问题是，有可能和公关一起去澳大利亚吗？	积极评估后获得澳大利亚公共关系的可能性有多大？	0
作为一个直人生活后，第一次同性恋是什么感觉？	异性恋男人害怕男同性恋吗？	0
为什么钢琴和小提琴演奏同一个音符时声音不同？我的老师说因为振幅不同。对吗？	白宫在现实生活中是否遭到恐怖分子的袭击？	0
专用车道上快速公交的最高速度是多少？	ZX-6R的最高速度是多少？	0
明天孟买的炸弹威胁是真的还是只是谣言？	我怎样才能靠区区1.5万英镑在孟买生活？	0
微生物有用的10种方式是什么？	如何利用微生物？	0
你认为你过去的生活是什么？为什么？	你认为你在过去的生活中是谁？	1
我可以通过自己的网站销售品牌商品吗？	访问俄罗斯萨拉瓦特时，有哪些鲜为人知的景点？	0
要消除所有比特币交易，需要发生的最小事件是什么？	有质量好的美国电影吗？	0
《真正的深水地平线》的幸存者们对最近的电影有何感想？	电影《深水地平线》的主题/意义是什么？	0
我该如何为大门做好准备，是否需要辅导？	是否有必要进行登机门准备辅导？	1
为什么我们会爱上一个我们不能在一起的人？	为什么我们会爱上一个我们不能成为他们爱的一部分的人？	1
加德满都最好的共同工作空间和会议室租赁选择是什么？	新加坡最好的共同工作空间和会议室租赁选择是什么？	0
如果一个人整天听音乐会发生什么？	如果我整天听音乐，我会有躁狂吗？	0
申请音乐研究生学位的最佳资源是什么？	申请历史研究生学位的最佳资源是什么？	0
结构化编程的新趋势是什么？	结构规划的新趋势是什么？	1
哪个是正确的语法：“如果你……，我将不胜感激”或“如果你……，我将不胜感激”？	如何更正WordPress手机语法错误？	0
我应该做些什么来提高我的英语水平？	尽快提高我英语口语的最好方法是什么？	1
为什么人们说奥巴马是黑人，而他有一半是白人？	奥巴马总统一半是黑人，一半是白人。很多美国人认为他是黑人，但似乎没有多少人，如果有的话，认为他是白人，这是为什么？	1
哪个Instagram标签最能吸引更多粉丝？	Instagram最喜欢的标签是什么？	1
阴道：做爱时，男人应该把阴茎放在哪里？	一个男人能保留他的阴茎并做手术来获得阴道吗？	0
唐纳德·特朗普是如何获胜的？	唐纳德·特朗普如何在预测他将失败的情况下获胜？	1
你是如何在口袋妖怪翡翠中冲浪的？	在神奇宝贝翡翠中，有没有一款神奇宝贝既能学冲浪又能学飞？	0
你和你的老师发生过性关系吗？	你有没有和老师发生过性关系？	1
1962年美国镍币的意义是什么？	1969年美国镍币的意义是什么？	0
什么是迪纳摩？	什么是发电机？	1
最近500卢比和1000卢比纸币的停止流通将对房地产或房地产业务产生什么影响？	500卢比和1000卢比纸币不被视为有效交易的声明如何影响印度的房地产？	1
优步司机在印度挣多少钱？	Uber driver在印度的收入是多少？	1
我怎样才能在孟买找到工作？	我如何在孟买找到工作？	1
朝鲜的日常生活怎么样？	朝鲜的生活怎么样？朝鲜不同阶层的人的典型生活方式是什么？	1
为什么最低工资应该提高到15美元？	所有美国工人的最低工资应该提高到每小时15美元吗？	1
如何拍摄专业照片？	拍专业产品照片的方法有哪些？	0
MacBook Pro中的铝与人手的反应如何？	计算机科学专业的学生使用MacBook的利弊是什么？	0
我将访问斯里兰卡9天，我如何才能接斯里兰卡女孩并享受乐趣？	印度人讨厌斯里兰卡人吗？	0
四节诗的好例子是什么？	有什么好的伊洛卡诺诗？	0
哪个CPU比第4代或第6代更好？	英特尔i5（第六代）和i7（第五代）哪个更好？	0
恰蒂斯加尔最好的旅游景点有哪些？	恰蒂斯加尔最重要的旅游景点在哪里？	1
爱情婚姻和包办婚姻有什么区别？	包办婚姻和爱情婚姻哪个更好？	0
如何破解诺基亚103中的安全码？	如何破解诺基亚C1中的安全码？	0
哪些网站最适合通过视频学习算法和数据结构？	从视频教程中学习数据结构和算法的最佳站点是什么？	1
海盗湾：在继续激流的同时，如何降低被抓住的风险？	我如何在没有被发现或被抓到的情况下在我的大学网络上进行激流？	0
你会给数学教育博客起什么名字？	对于一名机械/土木工程专业的IIT毕业生，如果他非常想从事计算机科学/数学的研究工作，并且在coursera中完成了CS的基础课程，你会给他什么建议？	0
联邦大亨从哪些大学招收新毕业生？他们在找什么专业？	联邦信号从哪些大学招收新毕业生？他们在找什么专业？	0
为什么人们在攻读工程学硕士学位之后还要攻读mba	为什么人们在工程学毕业后要攻读MBA？	1
facebook账户是如何被黑客入侵的？	如果某人没有被添加为好友，我如何破解他的Facebook帐户？	1
为什么黑人在非黑人说唱歌手使用N字时会感到不安？	为什么非黑人使用n这个词会被认为是冒犯性的，而黑人使用n这个词却不被认为是冒犯性的？	1
乔丹·贝尔福特在《华尔街之狼》中做了什么非法的事？	为什么华尔街的狼如此受欢迎？	0
没有安全套和怀孕风险，我如何进行安全性行为？	没有安全套，我如何进行安全性行为？	0
中国文化和西方文化的主要区别是什么？	西方文化和中国文化有什么不同？	1
Java做什么？我需要它吗？	我的电脑需要Java吗？	1
弱者和无知不是生存的障碍，傲慢是什么？	弱者和无知不是生存的障碍，傲慢是什么？（日语）	1
现在是将汽车与优步浦联系起来的时候了吗？	现在是在浦那将汽车与优步联系起来的适当时机吗？	1
拆掉你男朋友的乐高积木，保留一块重要的积木，这样它就再也不能完整了，这残忍吗？	我的岳母对我的孩子不感兴趣，也从来没有努力去了解他们，但却给我发了一些残酷的电子邮件。为什么？我没有对她做任何事。	0
你如何通过谷歌地球追踪手机？	谷歌地球是如何工作的？如何组合通过光卤石拍摄的图像？相机的分辨率是多少？	0
《枪与玫瑰》的原始成员重聚的可能性有多大？	为什么枪和玫瑰选择这个名字？	0
创业资金的不同阶段是什么？	在创业初期，最好是自己出资还是从风投那里获得资金？	0
我应该参加CBSE 12级改进考试吗？	参加CBSE改进考试比从学校重新参加CBSE 12班更好吗？在CSE和高等教育、MBA等方面的安置？	1
用2000张纸币取代1000张纸币会让黑钱囤积变得更加困难吗？	废除500卢比和1000卢比纸币的流通并引入新的2000卢比纸币将如何帮助遏制黑钱和腐败？	1
巴西传统服装的特点是什么？	你是如何爱上他/她的？	0
甲型肝炎的长期影响是什么？	乙肝的长期影响是什么？	0
如果我在一个额定功率为1kw的电表中安装一个2千瓦的交流电，它会烧坏电表还是导致短路？	电表可篡改吗？	0
英语字母表的第27个字母是什么？	英语字母表中有多少个字母？	0
是否有必要进行辅导以攻克JEE Advanced？	是否有必要参加辅导班来准备JEE高级课程？	1
地中海航运公司适合加入吗？	钦奈地中海航运公司好加入吗？	0
如何清除堵塞的耳朵？	我怎样才能解开堵塞的耳朵？	1
为什么男人比女孩更容易坠入爱河，但却更难做出承诺？有承诺问题的人能快乐地安定下来吗？	为什么男人这么容易坠入爱河？	0
我如何从网上赚钱？	在家赚钱的最好方法是什么？	1
我们的总理莫迪用500和1000卢比做的事情正确吗？	为什么纳伦德拉·莫迪在印度禁止发行500和1000张纸币？	1
如果我不是百万富翁，我有资格回答关于成为百万富翁的问题吗？	我厌恶风险。我如何成为百万富翁？	0
有哪些方法可以在一个月内减掉25磅？	我怎样才能快速减肥？	0
有没有科学证据证明鬼魂存在？	有没有对幽灵等无法解释的现象进行过认真的科学研究。？	1
你想知道你会怎么死还是什么时候死？	你宁愿知道你什么时候死还是怎么死？	1
我能做些什么来练习我的英语？	我怎样才能继续提高我的英语水平？	1
早起的最好方法是什么？	冬天我怎么能起得早？	0
墨西哥大学教育的成本是多少？	为什么大学教育的费用如此昂贵？	0
在Quora上有个人聊天的选项吗？	没有办法在Quora上与人聊天吗？	1
在悉尼哪里可以找到害虫防治服务？	在悉尼哪里可以获得环保害虫防治服务？	0
我可以用什么方法教我的孩子如何省钱？	你将如何教你的孩子金钱的价值？	0
用于健身房的索尼MDR-XB950耳机怎么样？	在1500到2000的范围内，哪种入耳式耳机适合购买？索尼、JBL或任何其他公司应优先选择哪一种？索尼MDR-XB450怎么样？	0
我应该从50个LAC开始做什么生意？	我有50个拉丁美洲和加勒比，想开始一个新的业务？我可以在孟买大规模开展哪些业务？	1
如果我关掉电脑，电脑上写着“准备好Windows，不要关掉电脑”，那会发生什么？	在移动电话中，有一个预定的电源开关，但我找不到任何可以打开电脑的东西。这些程序只能关闭计算机，不能打开计算机电源。如何在我想要的时间启动电脑？	0
几何序列的第一项是16，第五项是9。第七项的价值是什么？	AP的前n项之和为153，公共差为2。如果第一项是整数，那么n的可能值是多少？	0
人们能主动控制自己的情绪吗？	我如何获得情商并控制自己的情绪？	1
斯巴鲁WRX最好的年份是哪一年？	斯巴鲁WRX VS日产370z。哪个开车更有趣？	0
我准备好候补名单上的车票的图表后会得到退款吗？	如果在图表准备之前取消了等待名单，退款金额会减少多少？	0
从第一年开始，我应该如何准备破解谷歌代码之夏？	清除谷歌夏季代码的技巧是什么？	1
关于愚蠢有什么名言？	最愚蠢的引语是什么？	0
耶鲁大学是否提供富布赖特经济学奖学金？	印度是否有顶级远程大学提供的BSc经济学课程？	0
在班加罗尔哪里可以找到便宜但有品牌的衣服？	在班加罗尔哪里可以找到价格便宜的名牌服装？	1
我男朋友想和我肛交；它会痛还是感觉好？	我男朋友想和我做爱。对此我有复杂的感觉。我该不该做？	0
如果迈克尔今天还活着，迈克尔·杰克逊会怎么看唐纳德·特朗普？	各国的平均阴茎尺寸是多少？	0
如何与比你大5岁以上的人约会？	我怎样才能忘记一个我熟悉自己生活的人。我和他约会了5年多，我不知道该怎么办，我们还在谈，但这样行吗？	0
文化在生活中的重要性是什么？	文化在我们生活中的重要性是什么？	1
下列哪个句子是正确的？我昨天去看了我的医生，我昨天去看了我的医生，或者我昨天去看了我的医生	我最近也和一位医生交了朋友。这个句子语法正确吗？	0
在加拿大，一品脱啤酒的平均价格是多少？	为什么6包啤酒在澳大利亚要花这么多钱？	0
你为什么在乎别人怎么想？	我怎样才能停止担心别人的想法呢？	0
你如何提高对疼痛的耐受力？	你如何提高你的疼痛耐受力？	1
在F.R.I.E.N.D.S.之后的电视节目《乔伊》有多有趣。？	你看过F.R.I.E.N.D.S.之后看过乔伊的电视节目吗。？	1
我怎样才能去除胃部的脂肪团？	我的身体状况很好，但是我的大腿上部臀大肌下面有一块脂肪团，我怎么才能消除它呢？	1
潘卡：我的阿达尔卡丢了。我怎样才能得到第二份？	Aadhaar卡给持卡人带来了哪些好处？	0
印度现在最大的骗局是什么？	历史上最大的骗局是什么？	0
“很少”这个词是什么意思？	五个字母的单词是什么意思？	0
电信公司如何追踪我的位置？	我们如何追踪电话的来源或手机位置？	0
招聘经理告诉我，人力资源部将在大约1-2周内打电话询问下一步。？	迪拜和印度的oppo手机有什么区别？	0
我如何提高绘画水平？	你如何改进你的绘画？	1
如何在不知道苹果ID或密码的情况下解锁iPhone？	苹果知道我的iPhone代码吗？	0
为什么盐水太妃糖在日本进口？	为什么海水太妃糖是从日本进口的？	1
贾亚拉利塔的健康问题是什么？	首席部长贾亚拉利塔的健康状况如何？	1
离开公司时，给同事发送的最史诗般、最有趣的告别电子邮件是什么？	我要离开这个城市。我怎样才能在感情上告别呢？	0
为什么“坏男孩”这么有吸引力？	女孩对男孩的吸引力是否和男孩对女孩的吸引力一样大？	0
如果我的脚上有一根刺，而我自己又不能把它拔掉，我该怎么办？	如果你不能把它取下来，留下一块碎片可以吗？	0
健身：我能做些什么来减少我的大腹便便？	我如何减少肚子？	1
为什么有些人腋下出汗过多？	为什么有些人腋下出汗过多，却没有臭味？	1
谁是最腐败的印度政客？	印度政客有多腐败？	0
我怎样才能删除我的雅虎电子邮件帐户？	如何删除您的雅虎邮件ID？	1
您对2016年MacBook Pro有何评价？	您对MacBook Pro（2016）有何评价？	1
我需要NEET的户籍证明吗？	住所是否申请NEET第二阶段？	0
我是一名17岁的男性，身高5英尺6英寸。我能达到5英尺8英寸还是5英尺9英寸？	我今年16岁，身高5英尺6英寸，我能到5英尺9英寸吗？	0
印度哪个城市最适合居住？	印度北部哪座城市最好？	0
你听过的最不寻常的故事是什么？	你听过的最不寻常的爱情故事是什么？	0
有什么证据证明鬼魂真的存在吗？	鬼真的存在吗？如果没有，我们如何解释一些人被占有？	1
我如何从中度抑郁中恢复？	我怎样才能从抑郁中恢复？	1
什么是不注册Quora的好理由？	Quora入门：什么是Quora？	0
如果我给IIM A B和C 5颗星，你怎么评价L I和K？	在IIM-A，B，C，I，K，L的感觉如何？	0
在Ciroc伏特加中浸泡粘熊最好的方法是什么？	如果我只懂Python，它对高薪工作有好处吗？	0
我可以不用医生的处方独自服用维生素B复合物吗？	为什么叫维生素B复合物？	0
科技如何改变娱乐？	在印度，是否有新闻网站指定自己的记者并为他们发放身份证？	0
乌尔都语单词“Nasaaz”是什么意思？	乌尔都语单词“Ehteraam”是什么意思？	0
目前战锤40k中最具竞争力的名单是什么？为什么？	我如何知道下一步在战锤40K中选择哪支军队？	0
5年内需求量最大的编程语言是什么？	英国最受欢迎的编程语言是什么？	0
我如何从我的车上赚钱？	我怎样才能从我的车上赚钱？	1
工程师的薪水是多少？	工程师的工资是多少？	1
我怎样才能克服消极的想法？	我怎么能忽视消极的想法？	1
为什么最高法院指示卡纳塔克邦在TMC的第二个州放水？为什么卡纳塔克邦的水含量不能达到%TMC？见详情。	为什么即使最高法院禁止，IIT中也会出现破烂？	0
我怎样才能停止社交上的尴尬和内向？	作为一个害羞、社交尴尬的内向者，我如何结交朋友？	1
关于蚂蚁的一些鲜为人知的事实是什么？	关于蚂蚁的一些有趣的事实是什么？	1
如何在模板上创建类型书写效果？	如何在我的网站上创建打字效果？	1
我如何成为职业顾问？	要成为职业顾问必须做些什么？	1
我怎样才能阻止自己变得外向？	我该如何停止内向？	1
我应该买Xbox One还是PS4？为什么？	我应该买PS4、Xbox One还是游戏PC？	0
濒死体验是真实的吗？	濒死体验得到证实了吗？	1
用英语自我介绍的最好方式是什么？	你怎么能自我介绍？	0
手机有可能爆炸吗？	手机会爆炸吗？	1
当外国游客第一次被邀请到斯洛伐克某人的家时，他们应该带什么好礼物？	当外国游客第一次被邀请到乌克兰某人的家中时，他们应该带什么好礼物？	0
课后应用程序市场的创始人是如何影响青少年的？	放学后他们是如何想出自己的标志的？	0
最美的法国歌曲是什么？	有什么好的法语歌曲？	1
阿拉斯加的布什人在电视上赚了多少钱？	优步司机赚多少钱？	0
为什么Snapchat目前比Whatsapp成功多少？	Snapchat如何比Twitter更有价值？	0
唐纳德·特朗普如何在预测他将失败的情况下获胜？	唐纳德·特朗普是如何赢得总统选举的？	1
为什么我不能匿名跟踪Quora上的问题？	你为什么不能匿名追踪Quora的问题？	1
对于我的家庭wifi网络上的人来说，获取进出的所有数据，甚至是其他计算机发送的数据，有多难？	如果你有一个由太阳供电的连接两个星系的WiFi网络，发送和接收信息需要多长时间；光年还是光时？有没有办法提高连接两个星系的WiFi网络上的数据传输速度？	0
是否有JSON格式的景点（POI）数据源？	有JSON格式的音乐数据吗？	0
你如何定义粗野的性行为？	女人喜欢什么样的性，粗糙还是温柔？	0
第七次支付佣金后，所得税稽查员的期望工资是多少？	印度一名所得税稽查员的手上工资，新员工？	0
你一生中最挣扎的是什么？	你在生活中挣扎的是什么？	1
你能在排卵前5天怀孕吗？为什么？	月经5天后你能怀孕吗？	0
通过自学完成CBSE 11和CBSE 12课程大纲需要多少时间？有可能在6个月内完成吗？	我能在一个月内完成CBSE第11期的全部教学大纲吗？	0
学习乌尔都语的最佳来源是什么？	学习印地语的最佳来源是什么？	0
男人怎么看待那些行为愚蠢和自嘲的女孩？	如果一个胖乎乎的女孩喜欢他，男人们会怎么想？	0
为什么互联网只有28天？	哪种安全套最安全？	0
我怎样才能在迪拜生活和工作？	在迪拜生活和工作是什么感觉？	0
学习期间如何避免睡觉？	在枯燥的讲座中，我怎样才能保持清醒？	0
在我工作的时候，我的女朋友仍然和她的前男友聊天和闲逛。告诉她我不喜欢，但她说他们只是朋友。我应该担心吗？	这是什么样的伪装图案？	0
在现实世界中，国家之间是否曾发生过类似于《顶枪》中的斗殴？	电影《壮志凌云》中的呼号是什么？	0
为什么没有比光速更快的东西？	我们怎么知道没有什么能比光速更快呢？	1
如何确认我是否患有双相情感障碍？	你怎么知道自己是否患有躁郁症？	0
什么是不同类型的传播媒体？有哪些例子？	什么是不同类型的沟通？	0
对于数据科学家（iPython、PyCharm、Eclipse等）来说，最好的Python文本编辑器是什么？	如何在PyCharm中运行Python脚本？	0
你对500卢比和1000卢比纸币的禁令有何反应？这不会造成混乱，损害经济吗？	你对印度禁止发行500和1000面额纸币有何看法？	1
如何从计算机上完全删除/卸载Eclipse？	什么是霍霍本德？是病毒吗？如何将其从计算机中删除？	0
变压器开放三角形连接的功率因数是多少？如何确定？	领先功率因数对负载、变压器和发电机有什么影响？	0
如何找回丢失的T-Mobile手机？	T-Mobile的丢失手机政策是什么？	0
哪款单反相机比尼康D3300和佳能EOS1300D更好？	尼康D5500和佳能EOS 60D哪款单反更好？	0
你生命中的哪一刻彻底改变了你？	你生命中的什么时刻彻底改变了它？	1
如果有人与我共享他的谷歌硬盘，并在将来删除其中的一个文件，我的硬盘中是否可以使用该文件？	如何将共享文件（与我共享）永久保存在谷歌硬盘中（与我共享）？	0
500卢比和1000卢比纸币的禁令将如何影响印度经济？	你对印度禁止发行500和1000张纸币有什么看法？它将以何种方式影响印度经济？	1
破解数据库最简单的方法是什么？	你到底是如何破解网站/数据库的？	0
为什么希拉里·克林顿认为有必要使用私人服务器进行她的个人和政府通信？	希拉里作为国务卿设立自己的私人电子邮件服务器的真正原因是什么？	1
和你交往了6个月的男朋友搬到他那里住明智吗？	我怎么知道为什么我这么爱我只有6个月的男朋友？	0
我为什么要自尊？	为什么我们不能听约翰·列侬的？	0
我需要先看《哈利波特》再看神奇的野兽吗？在哪里可以找到它们？	在看《神奇野兽》之前，我应该先看哈利波特系列吗？在哪里可以找到它们？	1
我怎样才能读得更好？	通过阅读或只阅读本书来写自己的笔记更好？	0
我怎样才能在澳大利亚找到工作？	我如何在澳大利亚找到IT工作？	0
对于IIT Roorkee的理工类计算机科学专业学生，其他系提供的最好的学院工程选修科目是什么？	什么是最适合计算机科学理工类新生找工作的网站？	0
为什么有些工科学生很难找到工作？	为什么工科毕业生找不到工作？	1
按年龄划分的平均智商分数是多少？	在线检查我智商的最好方法是什么？	0
食物过敏在美国更常见吗？	为什么食物过敏在美国如此普遍？	0
数据恢复：我在iPhone上丢失了所有联系人，但他们都在iCloud中。我怎样才能把它们放回我的iPhone上？	如何从iPhone 6中恢复丢失的联系人？	0
印度的外科手术式打击会对巴基斯坦产生什么影响？	你如何看待印度对巴基斯坦恐怖分子的外科手术式打击？	0
印度军队最大的优势是什么？	印度军队的最大优势是什么？	1
第一人称、第二人称和第三人称的观点有什么不同？	什么是不同类型的观点？它们之间有什么不同？	0
为什么美国保守派和自由主义者害怕大政府？	特朗普和他的吹号者们什么时候认为美国以前是伟大的，他们计划如何让我们回到那个时代？	0
你认为聊天机器人真的是新应用吗？	聊天机器人是新的应用程序吗？	1
我们计划在班加罗尔的科拉曼加拉换班。那里有哪些相当好的学校？杰纳格尔有哪些学校？	班加罗尔最好的媒体学校是什么？	0
如何加热我的笔记本电脑？	为什么我的食物在微波炉里加热不均匀？	0
为什么日本和美国对南海的和平与繁荣以及菲律宾和中国之间的双边会谈如此不安？	为什么菲律宾在中国岛上击沉了它的美国二手军舰，从而污染了南海海域？中国应该对此采取措施吗？	0
金融建模在印度有什么范围吗？	印度金融建模的范围是什么？	1
作为一个人，纳伦德拉·莫迪怎么样？	见到纳伦德拉·莫迪怎么样？	1
哪一个是最好的创业加速器？	达拉斯最好的创业加速器是什么？	0
为什么他们说不能同时访问斯里兰卡卡拉哈斯蒂和提鲁帕蒂？	印度有哪些必须参观的寺庙？	0
我不想去上学，这就像每天的故事一样。我该怎么办？我在11年级。	我21岁了。我不再喜欢上学了，也不明白这有什么意义。我觉得我最近和朋友们太疏远了。我该怎么做才能让生活更有趣？我应该去什么地方冒险吗？	0
我们可以用多少种方式在Java中创建对象？	我们可以用多少种方法在java中创建对象？	1
在谷歌进行现场面试后，我没有得到SRE的职位。他们说他们会“把我的档案发给其他招聘人员。”这是常见的拒绝吗？	谷歌招聘：你是否希望在现场面试后发送一封感谢/后续电子邮件？	0
哪些印地语歌曲适合男性试唱？	什么是一些印地语歌曲，我可以在舞台上唱没有任何背景音乐，它会听起来很好？	0
我在哪里可以销售我未实现的商业理念？	我在哪里可以销售商业创意？	1
我可以在3G手机中使用Jio 4G sim卡吗？	3G手机上的Jio 4G？	1
我不告诉她是不是犯了个大错？	我犯了个大错，现在怎么办？	0
关于Quora的一个问题或答案是什么改变了你的生活？	Quora中改变你生活的一个问题或答案是什么？	1
为什么有些人仍然认为全球变暖是一个神话？	为什么还有人不相信全球变暖是真的？	1
邮局和银行有什么区别？	我在哪里可以找到邮政编码？	0
什么是最好的浪漫动画？	你最喜欢的浪漫动画是什么？	1
你如何描述这种风格？	你如何描述你的风格？	0
在哪些故事中，一名学生在JEE Main考试中没有取得好成绩，但在JEE Advanced考试中取得了好成绩？	吉普梅斯的低分选手有没有以高分进入IIT？	0
哪个是最便宜和最好的蓝牙扬声器？	Rs2000下哪种蓝牙扬声器最好？	0
马丁·海德格尔的童年对他的作品有何影响？	一个人怎么能回到童年？	0
有什么书可以扩展你的思维，增加你的智力？	哪些书可以扩展我们的思维？	1
印度孟买全新旅游许可证车辆的消费税退款是多少？（大众Vento 2015 highline MT）？	印度孟买全新旅游许可证车辆的消费税退款是多少？（汽车：大众Vento 2015 highline MT）	1
最后什么最重要？	在一天、一周、一个月、一年和一生结束时，什么是重要的？	1
你是如何从网上赚钱的？	在印度，我们如何在网上赚钱？	1
是什么使地球绕其轴线旋转？	地球绕地轴自转的原因是什么？	1
我们应该如何生活？	我们如何生活？	1
《行尸走肉》中你最喜欢的角色是谁？	电视连续剧《行尸走肉》中你最喜欢的角色是谁？为什么？	1
你应该给你的Lyft司机小费吗？	你应该给你的优步司机小费吗？	1
你的政治派别是什么？为什么？	什么是政治派别？	1
女王大学国际学生的录取率是多少？	当一个人发展为痴呆症时，什么样的性格特征可以预测更糟糕的结果/适应？	0
我应该做什么来准备NDA？	我如何在6个月内准备NDA？	0
你认为在印度禁止发行500和1000卢比纸币怎么样？	印度政府取消500和1000张纸币的决定是正确的还是一个大骗局？	1
在国际舞台上孤立巴基斯坦是否是印度在Uri袭击外交战线后能够采取的最佳步骤？	在乌里袭击后，应对巴基斯坦的最佳选择是什么？	1
如果有电容负载，电压调节是什么？	如果网站托管在负载平衡的web服务器上，并且必须在负载平衡器上启用粘性会话，并且必须在页面负载上执行会话检查，这意味着什么？	0
当WordPress博客在不同页面上显示不同数量的追随者时，我如何知道谁在关注它？	当遵循特定教义的宗教人士表示他们崇拜虚假神时，他们如何以及为什么会对遵循不同教义的人感到同情？	0
鲍勃·罗斯的一幅画值多少钱？我应该在易趣上出价多少？	鲍勃·罗斯为什么烫发？	0
21岁学吉他太晚了吗？	在21岁的时候学习唱歌是否太晚了？	0
我应该先学什么编程语言？	首先要学习的最好的计算机编程语言是什么？	1
远程设备或资源不接受Windows 8.1中的连接问题。我如何解决这个问题？	当我将Neo笔记本电脑重新设置为Windows 8.1时，它的扬声器不会发出声音。我怎样才能解决这种问题？	0
我如何开始我的创业？	创业的最佳方式是什么？	1
硅谷最好的餐厅是什么？	硅谷有哪些好餐馆？	1
有什么治疗月经来潮和腹胀的家庭疗法？	治疗腹泻的家庭疗法有哪些？	0
我如何练习精液保留？	什么是精液潴留？	0
最好的锻炼歌曲是什么？	哪些是最好的锻炼歌曲？	1
古吉拉特邦的下一个CM是谁？	谁将成为古吉拉特邦的下一个CM？	1
精液的味道是什么？	cum是什么味道？	1
我曾经拥有的和我曾经拥有的有什么区别？	“我曾经和我曾经”有什么区别？	0
黑钱是如何储存在瑞士银行的？	什么是黑钱？为什么黑钱存储在瑞士银行？	0
使用伪造的.edu电子邮件获得学生折扣是否违法？	Manipal学生是否有.edu电子邮件地址？	0
微信和QQ有什么区别？	为什么QQ比微信更受欢迎？	0
Gmail中的电子邮件从垃圾箱中删除后，有没有办法恢复？	有没有办法从我的Gmail帐户中检索我删除的电子邮件？	1
为什么Quora上的人会问一些关于事实的愚蠢问题，而这些事实很容易被谷歌搜索到？	为什么有些人会在Quora上问一些可以直接问到搜索引擎的问题？	1
航空公司知道我在机场买什么吗？	机场规划者对这部电视游戏系列《航空大亨》有何看法？	0
为什么人们在Quora上问这么愚蠢的问题？	为什么人们要问Quora问题？	1
认识理查德·费曼怎么样？	见到理查德·费曼是什么感觉？	1
在印度，我应该怎么做才能在网上赚钱？	有哪些简单的方法可以在网上赚到额外的钱？	1
如何自动备份Amazon EC2实例？	我无意中删除了没有快照或EBS备份的EC2实例。我或亚马逊可以恢复实例吗？	0
唐纳德·特朗普是美国的最佳人选吗？	唐纳德·特朗普是最佳总统候选人吗？	0
亚当和夏娃是什么颜色的？	亚当和夏娃之间谁是黑人？	0
您对总统候选人在2016年第一次辩论中的反应有何看法？	你如何看待希拉里和特朗普之间的首次总统辩论？	1
使用Adobe muse从web设计到web开发的最佳工作流流程是什么？	使用Adobe Muse从设计到开发的最佳工作流流程是什么？	1
作为一个18岁的女孩，我怎样才能增加体重？	作为一个青少年，我如何增加体重？	1
一个充满思想和情感的“人类”应该是什么样的？还是一个只工作的智慧物种？	一个建立在法律基础上的社会会是什么样的？它只执行人类之间没有武力、威胁或欺骗的自愿互动，而没有其他种类的法律？	0
我们能杀死一个黑洞吗？	黑洞能被摧毁吗？	0
我怎么会擅长书法？	我怎样才能有好的书法？	1
我怎样才能给我最好的朋友写一封时髦的信呢？他要出国留学了？	如果你在日本留学，要结交当地朋友有多难？	0
金属和非金属最常见的例子是什么？	金属碳酸盐的一些常见例子是什么？	0
为什么音乐中没有降c音？	在调换音乐时，我应该移动C键吗？	0
印度目前的政治状况如何？	印度当前的政治形势是什么？	1
我如何创造多种收入来源？	一个人能现实地创造多种收入来源吗？	1
你是怎么学会说英语的？	我怎样才能学会说一口流利的英语？	1
谁是更好的歌手：阿里吉特·辛格、莫希特·乔汉还是索努·尼加姆？	你们当中有多少人认为KK比Arijit Singh好得多？	0
为什么人们认为唐纳德·特朗普会成为一位好总统并投票给他？	唐纳德·特朗普为什么如此受欢迎？	1
我的前女友刚刚和她欺骗我的那个家伙生了个孩子，但那个混蛋抛弃了她，我该怎么办？	我怎样才能免费获得氏族之战宝石或黄金？‎	0
什么导致早产？	早产的原因是什么？	1
在印度，电子和通信工程师的工作范围是什么？	电子和通信工程师在印度有工作吗？为什么？	0
一个非摩门教的人在摩门教学院或大学里是什么感觉？	摩门教徒为什么不在教堂鼓掌？	0
男子体操应该穿什么样的内衣？	男人应该穿什么样的内衣？	0
肚脐穿孔是什么感觉？	肚脐穿孔如何闭合？	0
我的英语语法很差，我应该如何提高我的语法？	我能做些什么来提高我的英语语法？	1
在Trustmark工作的第一天，新员工应该知道哪些事情？	新员工在微软的第一天应该知道什么？	0
为什么我们不能阻止中国商品在印度的进口？	印度似乎在地理政治舞台上阻挠印度的一举一动，为何还要容忍中国？我们不能在印度封锁中国商品吗？	1
为什么从长远来看，你认为IFS比IAS更好？	为什么要选择IP而不是IAS？	0
“jocund”这个词在句子中是如何使用的？	在一个句子中“难以表达”这个词是如何使用的？	0
为什么有些问题显然不需要改进，却被标记为“需要改进”？	为什么我所有关于Quora的问题都需要改进？	1
我怎样才能坠入爱河？	如何坠入爱河。？	1
30000卢比范围内最好买哪台笔记本电脑？	哪台笔记本电脑在30000卢比以下最好？	1
一个国家的经济制度如何影响有意在那里做生意的外国公司？	哪种颜色最适合雷鸟，哑光黑还是普通黑？	0
男人容易忘记他们喜欢的女孩吗？	达尔文剽窃了他的进化论，这是真的吗？	0
如果我现在就开始准备，是否有可能打开JEE电源并提前2016年？	如果我现在就开始准备2016年的JEE干线是否太晚了？	1
罗伯特·J·库珀的死因是什么？	是否有衰老导致的死亡？	0
印度哪些是最好的在线公司？	印度最好的IT公司是哪家？	0
为什么人们相信上帝，他们怎么能说他/她存在？	为什么人们相信更高的力量和上帝？	1
你在罗马旅行中最精彩的个人经历是什么？	你到菲律宾旅行最令人惊奇的个人经历是什么？	0
我如何成为Quora的顶级作家，获得更多的选票和更好的统计数据？	你如何成为2014年Quora的顶级作家？	1
我如何让印度成为一个廉洁的国家？	印度必须采取什么措施让印度免于腐败？	1
进步派和自由派是如何看待罗纳德·里根的？	罗纳德·里根的自由主义观点是什么？	0
哪些印度医学院在美国享有良好声誉？	哪个更有价值？美国还是德国的硕士？这是关于我的朋友——目前正在孟买一所著名大学攻读计算机工程BTech	0
浦那最好的食物是什么？我在哪里买的？	浦那最好的食物是什么？	1
什么是DDoS？	什么是DDoS攻击？	0
一个现实的减肥计划是什么？	我怎样才能有效地减肥？	1
你最喜欢的7本书是什么？	你一直最喜欢的书是什么？为什么？	0
我怎么确定手表上的日期？	劳力士Day Date手表的内部是什么样子的？	0
我最近被荷兰埃森哲公司聘为技术顾问。我被聘为11级分析师，在这个级别工作了12个月。我第一次晋升为顾问需要多长时间？	我在埃森哲的职业水平是11。如果我终身工作，我将如何获得晋升和加薪？	0
什么是Visual FoxPro数据库？	什么是visualfoxpro？	0
我如何区分美国宇航局的所有航天飞机？	航天飞机之间有什么实质性的区别吗？	1
完成Bcom后我可以做什么？	完成bcom后我应该做什么？	1
谷歌Pixel的摄像头比任何其他手机甚至iPhone都要好多少？	我已经三个月没有月经了（上次月经在6月9日结束）。我17岁，从未有过性行为。我该怎么办？	0
在哪里可以找到创业顾问？	我怎样才能找到能够帮助我成立初创公司的顾问？	0
你如何带着一颗破碎的心继续前行？	你是如何克服一颗破碎的心的？	1
为什么没有印度数学家获得菲尔兹奖章？	为什么印度出生的人从未获得菲尔兹奖章？	1
朝鲜战争是一场骗局吗？	谁赢得了朝鲜战争？	0
哪一种是最好的Teradata在线培训？	Teradata在线培训的最佳机构在哪里？	1
YIF实习情况如何？	YIF的课程结构给我留下了深刻的印象。我希望在市场营销方面取得成功。加入YIF对我来说是个好选择吗？	0
你如何区分从中国进口的假塑料大米和不含塑料的真大米？	亚洲人怎么能一天吃三次米饭？	0
27岁毕业真的是一个很大的劣势吗？	如果我上的是60年代中期的CS学校，我在研究生入学方面的劣势有多大？	0
印度的预订系统（配额）将持续多久？	基于种姓的保留制度会在印度终结吗？	1
机械能的优点是什么？	X射线和伽马射线有多少能量（单位：eV）？	0
斯堪的纳维亚高地的旅游景点与比利时的景点相比如何？	斯堪的纳维亚高地的旅游景点与荷兰的景点相比如何？	0
开博客怎么赚钱？	我如何通过开博客开始赚钱？	1
我丈夫在我们吵架的时候敲打东西，把它们弄坏了。但他从来没有打过我。他不通过讨论来解决问题。他还辱骂我。我只是等着被他打吗？这是他的下一步吗？	我向一个我喜欢他的人承认，后来听说他喜欢我。他从来没有告诉过我。当他没有下定决心而我继续前进时，他为什么生我的气？	0
破解whatsapp的东方之路是什么？	有人能用WhatsApp破解我的智能手机吗？	1
您2017年的新年决心是什么？	您正在考虑为2017年制定哪些最疯狂的新年计划？	0
教育对美国的重要性是什么？他们对教育的看法与丹麦有何不同？	教育对美国的重要性是什么？他们对教育的看法与斯洛伐克有何不同？	0
有可能在一个月内减掉17磅吗？	减肥的最好方法是什么？	0
什么是苏格兰鸡蛋？它们是什么时候发明的？	苏格兰鸡蛋是什么？它们的起源是什么？	1
为什么有些人睡觉时不做梦？	为什么日本人不睡在床上？	0
工作面试缺陷？	如果伊朗不打算制造核武器，那么伊朗核协议的目的是什么？	0
荣誉对毕业意味着什么？	我无法从日常保险中获得索赔金额？	0
有没有法律禁止海军军官在证人席上穿Rustom所示的制服？	是否有任何法律禁止体育联盟影响比赛结果，以增加门票销售和广告收入的利润？	0
当你刚加入一家新公司时，请临时假的最佳借口是什么？	我应该给我的经理什么借口离开我一个月前刚加入的工作？	0
狗能吃葡萄果冻吗？为什么？	葡萄对任何品种的狗都有害吗？	0
波士顿啤酒2016年推出的最有趣的产品和创新是什么？	波士顿科学在2016年推出的最有趣的产品和创新是什么？	0
危地马拉有什么样的政府？它和加拿大的相比如何？	危地马拉有什么样的政府？它与委内瑞拉的情况相比如何？	0
萨提亚巴马是一所好大学吗？	维多利亚大学擅长什么？	0
轧棉机对美国奴隶制的影响是什么？	奴隶制对南方在全球棉花贸易中的竞争力有多重要？	0
情侣们玩的最好的游戏是什么？	对一对夫妇来说，什么是好游戏？	1
在月经周期中（月经前/月经中/月经后），什么可能导致棕色分泌物？	为什么我在月经周期前会有棕色分泌物？	1
我如何用“Quora”上的图片提问？	如何使用照片提问？	1
所有成功的销售人员都有哪些共同的技能？	所有成功的销售人员都有哪些共同的性格特征？	1
我丢失了CBSE第10和第12次及格证书，我对申请副本有疑问，还有其他人申请吗？	我丢了CBSE委员会的12级证书。我该怎么办？	0
什么是一部虚构的作品，是真正的好，但有一个可怕的球迷基础？	哈利波特/迪安·托马斯·范的一些好小说是什么？	0
你如何在大使馆或领事馆找到工作？	你怎么能在大使馆找到工作？	1
猪排最好的配菜是什么？	排骨有什么好的配菜？	0
如果图帕克·沙库尔还活着（假装死亡）并再次公开露面，那么他在刑事上会怎么样？	如果艾略特·罗杰没有自杀，而且还活着，他会面临什么指控，他的刑期是什么？	0
什么是sigmoid函数，它在机器学习的神经网络中有什么用途？	机器学习如何应用于金融？	0
支持以色列定居点的理由是什么？	以色列定居点有什么防御措施？	1
什么是oracle erp云？	什么是oracle erp？	0
你如何成为印度的自由撰稿人？	我怎样才能成为印度的自由撰稿人？	1
在第一季第一集《高城堡里的男人》结尾的最后一个电话是什么意思？	《城堡里的男人》中的电影是从哪里来的？	0
我怎样才能把自己画成一个动漫人物呢？	我如何画我的动画角色？	1
如果号码不在我的联系人列表中，为什么来电显示不在手机上显示来电者的姓名？	如何在Android手机上访问来电显示？	0
你认为自由的真正含义是什么？	自由对你意味着什么？我们真的有空吗？	0
耶稣的使徒们在受难后回到了他们的日常工作中吗？	当耶稣说其中一个使徒（犹大）将背叛他，因为这是根据上帝的救赎计划，犹大是命中注定要下地狱的吗？	0
艾萨克·牛顿吸烟是真的吗？	艾萨克·牛顿早产并患有自闭症或强迫症，这是真的吗？	0
典型的美军基地早餐供应什么？	美国军队有多先进？	0
亚利桑那州拉文附近合适的太阳能电池板安装供应商是什么？	亚利桑那州尤马市合适的太阳能电池板安装供应商是什么？	0
人是万恶之源吗？	男性行为是万恶之源吗？	0
为什么Quora上的一些答案说“此时无法添加评论”？	为什么有些答案没有评论部分？	1
怎样才能控制自己的愤怒？	控制愤怒的最好方法是什么？	1
对于中高级营销经理来说，最好的数字营销课程是什么？	印度线上和线下最好的数字营销课程是什么？为什么？	1
什么是好的Virat Kohli模因/笑话？	Rohit Sharma嫉妒Virat Kohli吗？	0
我必须在艺术方面有多好才能被艺术学校录取？	一个艺术家应该上艺术学校才能成功吗？	0
什么是变换？	什么是变压器？	0
艾哈迈达巴德最好的反渗透净水器是什么？	印度最好的净水器是什么？	0
为什么我不能将我的朋友添加回Snapchat？	如果从snapchat中删除某人，如何将其重新添加？	0
盖特考试的标准化分数是多少？	大门的标准化分数是多少？	1
我如何给准岳母留下深刻印象？	我如何给婆婆留下深刻印象？	1
小狗什么时候停止咬人？	我2个月大的雌性金毛猎犬经常咬人。这看起来不像是玩咬人游戏。她咬得很凶。即使我们走过她身边，她也跟着我们，使劲咬我们。我该怎么做才能阻止我的小狗咬人？	0
电气工程中有哪些有趣的研究领域？	电气工程领域的热门研究领域是什么？	0
你在餐馆里最糟糕的经历是什么？	你有过的最糟糕的餐馆体验是什么？	1
世界上最快的超级计算机暴力破解密码的速度有多快？	使用什么方法来对抗暴力密码攻击？	0
麻省理工学院不同专业学生的快乐/不快乐率有什么不同？	达特茅斯的学生快乐/不快乐的比率在不同专业之间有什么不同？	0
惠普和戴尔哪款笔记本电脑更好？	谁的笔记本电脑更好，惠普还是戴尔？	1
如何从祖先网站打印家谱？	如何打印来自祖先的文档？	0
智商测试是如何进行的，阿拉巴马州的平均分数是多少，与田纳西州相比如何？	如何进行智商测试，阿拉巴马州的平均分数是多少，与德克萨斯州相比如何？	0
是什么决定永远改变了你的生活？	一个永远改变你生活的决定是什么？	1
为什么油价在下降？	为什么原油价格在下降？	1
最被低估的旅游目的地是什么？	最被低估的欧洲旅游目的地是什么？	0
你如何克服态度问题？	你如何解决态度问题？	1
根据我的个人资料，我可以申请美国哪些大学的计算机科学硕士学位？	根据我的个人资料，我应该申请哪些学院的计算机科学硕士学位？	0
关于死亡有什么想法？	你认为死后会发生什么？	0
我发现了这些上面有阿拉伯语的针盒。有人能翻译一下吗？	我是一名翻译，希望与有前途的初创公司合作，在德国引进这些技术。我从哪里开始寻找和接近他们？	0
美国总统和他的家人必须住在白宫吗？	美国总统住在白宫时，对他们的房子做了什么？	0
Acer Liquid Z630S安卓智能手机通过CPU-Z应用程序提供哪些传感器？	您最常使用的智能手机上的五个应用程序是什么？	0
在我的安卓设备启动之前或之后，我应该安装哪些应用程序？	哪些Android应用程序在根目录之前是必需的？	0
在你父母去世后，作为一名青少年被收养的感觉如何？	作为父母，看到你的孩子肥胖是什么感觉？	0
我对那里的女孩有感觉，但我很快就要离开了。我是否应该直接问那个女孩，当我还在这里的时候，我是否可以每个月给她送花？	我想我正在培养对一个女孩的感情。我没有机会和她在一起，因为她有男朋友。在她离开之前我还应该告诉她吗？	0
为什么人们反对修正案14？	为什么最近苏拉特禁止使用OCB（卷筒纸）？	0
我们不应该在NaMo和RaGa之间进行类似于美国总统辩论的辩论吗？	为什么美国有总统辩论而印度没有？	1
人类行为：你反复告诉自己的一个谎言是什么？	你最常说的谎话是什么？	1
我怎样才能通过70-680认证考试？	我怎样才能通过70-410考试？	0
你怎样才能健康？	我怎样才能适应德国？	0
如何应用随机梯度下降？	随机梯度下降中的动量意味着什么？	0
我想买一台低于20000卢比的32英寸LED电视。在线LED电视安全吗？	在20000卢比以下购买哪款32英寸led电视最好？	1
蓝色的法国号象征着什么？	法国号值得一试吗？	0
Netflix多久向其流媒体收藏添加一次新标题？	平均而言，Netflix在票房发行后多久才能推出新电影流媒体？	0
“为什么我不应该雇用你？”这个问题的正确答案是什么	为什么我不应该雇用你，最好的答案是什么？	1
一年中游览冰川国家公园的最佳时间是什么时候？	参观死亡谷国家公园的最佳时间是什么时候？	0
每天坐在电脑前10个小时健康吗？	对于每天坐在电脑前超过10个小时的人来说，去健身房是保持健康的最佳选择吗？	0
李小龙是怎么死的？	谁杀了李小龙？	0
为了更好地理解时间线，应该按哪个顺序观看所有惊奇漫画电影（和电视节目）？	按照什么时间顺序观看所有Marvel MCU电影？	1
你如何对你不感兴趣的事情产生真正的兴趣？	我如何在生活中培养更多的兴趣？	0
耶稣基督的死亡、埋葬和复活有什么证据？	复活的耶稣基督是否有圣经以外的证据？	1
什么是火车？	什么是培训？	0
如何确定氢氧化锌的溶解度？	如何确定氢氧化锂的溶解度？	0
Safari最好的URL短接扩展是什么？	最好的YouTube Safari扩展是什么？	0
如果有人不回复邮件，而我不得不重复发送邮件，我是否应该假装以前没有给他们发过邮件？	如果我在聚会后给某人发电子邮件（在他们鼓励我给他们发电子邮件之后），而他们甚至在发了多封电子邮件后也懒得回复，这意味着什么？	0
成为一名专业的网页设计师需要多长时间？	成为一名优秀的网页设计师需要多长时间？	1
自杀的最佳方式是什么？	自杀的最简单方式是什么？	1
机械键盘真的有助于触摸打字吗？	机械键盘有助于触摸打字吗？	1
什么是比特币？它是如何工作的？这合法吗？谁是幕后操纵者？	什么是比特币挖掘工作原理的直观解释？	0
今天最好学的编程语言是什么？	计算机编程需要多少种语言？哪种语言最好？	1
为什么在回归模型中需要一个误差项？它的统计分布是什么？	回归的误差项是什么？	0
全球变暖是真的还是恶作剧？	全球变暖有可能是一场恶作剧吗？	1
谁是大将军，俄罗斯的朱可夫还是德国的冯·曼斯坦？为什么？	谁是俄罗斯的朱可夫元帅，还是德国的范曼斯坦？为什么？	1
一支标准的茶烛光能产生多少能量/热量？	光能只转换成热能吗？它不能转换成其他能量吗？如果能给我举个例子？	0
奥斯曼尼亚大学排名？	有哪些方法可以还原Windows 7笔记本电脑？	0
在新泽西买鞋要缴纳销售税吗？	在新泽西我能住在哪里？	0
什么是银行订单的sallary？	我经常对我的女朋友大喊大叫，即使是因为一些愚蠢的事情。但我爱她胜过一切。我应该做些什么来控制我的愤怒并开始爱她？	0
如果猫和狗长出相反的拇指，最有可能发生什么？	为什么人们喜欢狗而不是猫？	0
牙齿不好会让人更快地死去吗？	牙齿不好是否意味着你会英年早逝？	1
唐纳德·特朗普是如何赢得选举的？	唐纳德·特朗普怎么能在人们如此憎恨他的情况下赢得选举？	1
医生如何进入生物技术或分子生物学领域？	医生如何进入生物技术行业？	1
我如何在迪拜赚取额外收入？	我如何在德里赚取额外收入？	0
在技术面试和招生团队结束后，我给面试官发了电子邮件。为什么我没有得到他们两个的答复？	我已经通过他们的网站申请了思维工程公司。我收到他们人力资源团队的邮件，要求我建议一个电话面试的日期。我已经回复了同样的回复，但仍然没有得到他们的任何回复。他们会在没有通过邮件通知的情况下打电话吗？	0
哪一个是最好的测试系列SSC CGL Tier 2考试？	在哪里可以找到SSC CGL tier 2的模拟试卷？	1
你犯过的最严重的错误是什么？	人类犯过的最严重的错误是什么？	0
为什么龙皮盔甲被美军拒绝？	向美国军队宣誓就职是什么感觉？	0
公共部门单位工作和政府工作有什么区别？	在印度，公共事业单位（PSU）工作和政府工作有什么区别？	1
卡皮尔·夏尔玛一场演出要多少钱？	如果Alia Bhatt女士被邀请作为Kapil Sharma秀的嘉宾怎么办？	0
贾亚拉利塔的健康状况如何？	泰米尔纳德邦CM J Jayalalitha的真实健康状况是什么？	1
广东话和普通话有何不同？	广东话和普通话有什么区别？	1
你应该购买哪些最好的iphone小工具？	真正值得购买的最好的iPhone小工具是什么？	1
WhatsApp能被黑客攻击吗？	WhatsApp黑客攻击可能吗？	1
异国情调的汽车销售员比主流市场的销售员挣得多吗？	有针对异国车的碰撞测试吗？	0
冰比水轻吗？	为什么冰比水轻？	1
一百万美元能做什么？	我如何投资一百万美元？	0
为什么我从不做噩梦？	我为什么不做噩梦呢？	1
我如何与我的经理打交道？	你是怎么对付你讨厌的经理的？	0
圣经中的撒母耳是谁？	圣经中的约拿是谁？	0
如何将我的音频磁盘转录成在线文本？	如何将印地语音频文件转换为文本？	0
在《商品及服务税条例草案》中，当只应征收一种税种时，SGST、IGST和CGST的含义是什么？	一旦GST法案通过，Flipkart会返回喀拉拉邦（货到付款）吗？（只是因为商品不会单独征收销售税。）	0
学习UI设计的在线资源有哪些？	学习软件UI设计的好资源是什么。	1
我怎样才能减掉70磅？	有没有一种健康安全的方法可以让你在一个月内减掉20磅并保持体重不变？	0
Kamakshi的眼睛在Kanchipuram移动吗？	我计划和我的家人一起从索尼帕特乘公交车到马纳利旅行3天。我应该如何计划使成本最小化？	0
什么是好的心理技巧？	最酷的心理技巧是什么？	1
黑洞中光子的速度是多少？	被奇点吸引的光子的速度是多少？	0
我怎么能有女人味？	我怎样才能更优雅更女性化？	0
我如何在HSC马哈拉施特拉邦委员会中取得好的分数？	在第12届HSC委员会考试中，我的物理成绩如何？	0
你如何处理情绪虐待的父母？	日常生活心理学：我如何应对情绪虐待的父母？	1
我想要一个真正有效的方法，在我没有钱投资的情况下，每月赚500美元？	在我没有钱投资的情况下，每月赚500美元的真正有效方法是什么？	1
核弹的基本用途是什么？	核弹的用途是什么？	1
禁止500卢比和1000卢比纸币对印度经济有什么影响？	引入新的500和2000面额货币以及停止使用旧的500和1000面额货币如何帮助/影响印度经济？	1
xnxx.com由什么web脚本或CMS组成？	福布斯网站使用什么CMS？	0
是什么促使命运之轮在奖金回合中使用字母R S T L N和E？	在命运之轮上，为什么会有这么多的掌声？它发生在每个轮子旋转之后&在任何人说任何话之后。	0
寻找廉价航班的技巧和技巧是什么？	预订便宜机票有什么困难？	1
让企业家伤心的是什么？	什么事情让你伤心？	0
RNN（递归神经网络）的注意机制到底是什么？如果你能让它更容易理解，那就太好了！	为了更好地理解人工神经网络，Hebbian学习机制对学习是必不可少的吗？跳过Hebbian机制可以吗？	0
加拿大学生签证持有人能否获得永久居留权？	我怎样才能用学生签证合法地移居加拿大？	0
如何选择乌代布尔最好的出租车服务？	我如何选择乌代布尔最好的出租车服务？我怎么能找到呢？	1
唐纳德·特朗普真的是种族主义者吗？	你认为唐纳德·特朗普是种族主义者吗？若然，原因为何？	1
我怎样才能在伦敦找到投资银行的工作经验？	我如何找到在伦敦的投资银行工作经验？	1
DBMS中的弱实体是什么？为什么叫弱？	DBMS中的强实体集和弱实体集有何不同？	1
有哪些初学者级别的动态编程问题可以在CodeChef和其他在线评委上练习？	在Topcoder、Codeforces、Codechef和SPOJ上使用动态编程有哪些好问题？	0
Quora有用吗？	Quora最有用的是什么？	0
为什么光子不服从E=mc^2？	在给定[math]E=mc^2[/math]的情况下，光子怎么可能没有质量却仍然有能量？	0
是什么导致汽车在行驶时失去动力？	如果我的车在行驶中失去动力，我该怎么办？	0
婚后月经不规律会推迟怀孕吗？	月经不规律会影响女性生育吗？	1
什么是营销总监？	当营销总监是什么感觉？	0
什么是电子建筑？	Java中的构造函数是什么？	0
Edgware区是什么？与伦敦伊斯灵顿区相比，这里的生活方式如何？	Edgware郡是什么？它的生活方式与伦敦恩菲尔德区相比如何？	0
日常生活中摩擦的例子有哪些？	对日常用品的最佳生活技巧是什么？	0
在海得拉巴学习大数据课程最好的机构是什么？	海得拉巴最好的大数据研究机构是什么？	1
5周内减掉40磅的安全方法是什么？	在两周内减掉40磅安全吗？	0
我能从Quora那里挣钱吗？	我如何使用Quora来赚钱？	0
我应该选择哪一个MBA选项：TERI还是ISBR？	你对新德里泰瑞大学有何评价？	0
有哪些电影你一辈子都看不到？	一个人一生中必须看哪些电影？	0
《星巴克周末》这首歌中的每一行是什么意思？	《周末的瓦莱丽》这首歌是什么意思？	0
你一天会做爱多少次？	一个人每天应该做爱多少次？	1
是什么导致人们通过外表来判断一个人？	为什么我们经常以外表来判断人？	1
作为首席技术官，我应该获得多少股权？	作为首席技术官/联合创始人，我应该获得多少股权？	1
一个人如何射精而不达到高潮？	一个人能在没有高潮的情况下射精吗？	1
像印度这样的国家需要什么样的总统？	像印度这样的国家需要总统吗？	1
最棒的露营新发明有哪些？	哪些是最好的户外新技术发明？	0
为什么印度人痴迷于上帝和宗教？	印度人如此痴迷于宗教和种姓的概念吗？	1
如何提高我的c编程技能？	如何改进我的C编程？	1
什么是一些有趣的宝莱坞经典歌曲？	2016年最有趣的宝莱坞歌曲是哪首？	0
菲律宾最好的工作是什么？	菲律宾最好的作品是什么？	1
如果你有无限的钱，你想做的一件事是什么？	如果你有无限的钱，你会用你的一生做什么？	1
谁拥有FinViz.com？	谁拥有比尔盖茨网站？	0
我如何在网上轻松赚钱？	如何利用可用的投资快速轻松地在网上赚钱？	0
我如何测量我的身体脂肪？	我如何适当地减少身体脂肪？	0
欧洲最适合创业的国家是什么？	（作为美国公民）在哪个欧洲国家创业最好？	1
为什么有些人不相信上帝？	为什么有些人是无神论者？	0
哪一个是正确的？“如果您有任何问题，请告诉我”或“如果您有任何问题，请告诉我”	说“如果你需要帮助，请告诉我”或我必须用“是否”是正确的吗？	0
为什么有些答案会在Quora中崩溃？	为什么Quora上有这么多高质量的答案？	1
你读过的最好的非小说类书籍是哪本？	我应该读哪些好的非小说类书籍？	1
印度最好的SIP计划是什么？	印度哪一个最佳的SIP投资计划？	1
墨西哥的汽油是从哪里来的？	从墨西哥来的人怎么能进入麻省理工学院？	0
纯化水和蒸馏水有何不同？	蒸馏水和纯化水是如何相同的？	1
我是否需要任何关于《星球大战》系列的知识来观看/欣赏《盗贼一号：星球大战》的故事？	我必须看过其他星球大战电影才能理解《盗贼一：星球大战故事》吗？	1
我的主板上需要什么类型的散热器？	安装Mac需要什么样的硬件？	0
自动取款机在收付现金时出错的频率是多少？	你怎么能找到最近的自动取款机里是否有现金？	0
李小龙能忍受MMA拳手吗？	李小龙在巅峰时期能与当今的顶级MMA拳手抗衡吗？	1
在欧洲谨慎地致富是什么感觉？	谨慎地富有是什么感觉？	0
白宫是奴隶建造的吗？	白宫完全是由奴隶建造的吗？	1
什么是最好的口袋妖怪黑客？	哪些是最好的口袋妖怪围棋？	1
什么是“真正的程序员”？	“真正的程序员”的定义是什么？	1
这个C程序的输出是什么？	这个C++程序的输出是什么？	0
为什么配电需要降压？	我们为什么不说“无法理解”呢？毕竟，我们说“可以理解”	0
人生中最大的错误是什么？	咒语在本质上总是好的吗？你能分享一些邪恶的咒语和它们的意思吗？	0
